//MAP CONVERTED BY dmm2tgm.py THIS HEADER COMMENT PREVENTS RECONVERSION, DO NOT REMOVE
"aj" = (
/obj/structure/sink{
	dir = 8;
	pixel_x = 11
	},
/turf/open/floor/mineral/titanium/white,
/area/shuttle/escape)
"aq" = (
/obj/structure/closet,
/turf/open/floor/mineral/titanium/yellow,
/area/shuttle/escape)
"az" = (
/obj/effect/turf_decal/siding/green/corner{
	dir = 1
	},
/obj/effect/turf_decal/siding/purple/corner{
	color = "#4D0067";
	dir = 4
	},
/turf/open/floor/mineral/titanium/white,
/area/shuttle/escape)
"aH" = (
/obj/structure/chair/comfy/shuttle{
	dir = 1
	},
/turf/open/floor/mineral/plastitanium/red/brig,
/area/shuttle/escape/brig)
"aX" = (
/obj/machinery/light{
	dir = 4
	},
/turf/open/floor/mineral/titanium/tiled,
/area/shuttle/escape)
"bb" = (
/obj/structure/table/reinforced,
/obj/item/storage/box/zipties,
/turf/open/floor/mineral/plastitanium/red/brig,
/area/shuttle/escape/brig)
"bh" = (
/obj/effect/turf_decal/siding/red,
/obj/machinery/light{
	dir = 1
	},
/turf/open/floor/mineral/titanium/white,
/area/shuttle/escape)
"cf" = (
/obj/structure/chair/comfy/shuttle{
	dir = 8
	},
/turf/open/floor/glass/reinforced,
/area/shuttle/escape)
"cD" = (
/obj/structure/closet/crate,
/obj/item/bouquet/sunflower,
/turf/open/floor/mineral/titanium/yellow,
/area/shuttle/escape)
"dw" = (
/obj/structure/bed/roller,
/obj/machinery/iv_drip,
/turf/open/floor/mineral/titanium/blue,
/area/shuttle/escape)
"eP" = (
/obj/machinery/computer/secure_data{
	dir = 4
	},
/turf/open/floor/mineral/titanium/white,
/area/shuttle/escape)
"fx" = (
/obj/structure/toilet{
	dir = 1
	},
/obj/machinery/light/small{
	dir = 4
	},
/turf/open/floor/mineral/titanium/white,
/area/shuttle/escape)
"fL" = (
/obj/structure/extinguisher_cabinet{
	pixel_y = -32
	},
/obj/machinery/light,
/turf/open/floor/mineral/titanium/white,
/area/shuttle/escape)
"gP" = (
/obj/machinery/light{
	dir = 1
	},
/turf/open/floor/mineral/titanium/white,
/area/shuttle/escape)
"ii" = (
/turf/open/floor/mineral/plastitanium/red/brig,
/area/shuttle/escape/brig)
"jB" = (
/turf/closed/wall/mineral/titanium,
/area/shuttle/escape)
"ka" = (
/obj/effect/turf_decal/siding/yellow{
	dir = 1
	},
/turf/open/floor/mineral/titanium/white,
/area/shuttle/escape)
"kK" = (
/obj/structure/table/reinforced,
/obj/item/defibrillator/loaded,
/turf/open/floor/mineral/titanium/white,
/area/shuttle/escape)
"kS" = (
/obj/effect/turf_decal/siding/green{
	dir = 8
	},
/obj/effect/turf_decal/siding/purple{
	color = "#4D0067";
	dir = 4
	},
/turf/open/floor/mineral/titanium/white,
/area/shuttle/escape)
"ld" = (
/obj/structure/closet/crate,
/obj/structure/window/reinforced{
	dir = 8;
	layer = 2.9
	},
/turf/open/floor/mineral/titanium/yellow,
/area/shuttle/escape)
"lQ" = (
/obj/structure/table/reinforced,
/obj/item/storage/backpack/duffelbag/med/surgery,
/turf/open/floor/mineral/titanium/white,
/area/shuttle/escape)
"mp" = (
/obj/effect/turf_decal/siding/yellow/corner{
	dir = 1
	},
/obj/effect/turf_decal/siding/green/corner{
	dir = 4
	},
/turf/open/floor/mineral/titanium/white,
/area/shuttle/escape)
"nl" = (
/obj/effect/turf_decal/siding/yellow/corner{
	dir = 8
	},
/obj/effect/turf_decal/siding/green/corner,
/obj/machinery/light{
	dir = 1
	},
/turf/open/floor/mineral/titanium/white,
/area/shuttle/escape)
"no" = (
/obj/effect/turf_decal/siding/purple/corner{
	color = "#4D0067";
	dir = 1
	},
/obj/machinery/light{
	dir = 4
	},
/turf/open/floor/mineral/titanium/white,
/area/shuttle/escape)
"nv" = (
/turf/closed/wall/mineral/titanium/nodiagonal,
/area/shuttle/escape)
"nE" = (
/obj/structure/chair/comfy/shuttle{
	dir = 1
	},
/obj/machinery/light,
/turf/open/floor/mineral/plastitanium,
/area/shuttle/escape)
"nO" = (
/obj/structure/sign/directions/engineering,
/turf/closed/wall/mineral/titanium,
/area/shuttle/escape)
"oj" = (
/obj/machinery/door/airlock/security/glass{
	name = "Holding Area";
	req_access_txt = "2"
	},
/turf/open/floor/mineral/plastitanium/red/brig,
/area/shuttle/escape/brig)
"ou" = (
/obj/machinery/door/airlock/titanium,
/turf/open/floor/mineral/plastitanium,
/area/shuttle/escape)
"oI" = (
/obj/machinery/recharge_station,
/turf/open/floor/mineral/plastitanium,
/area/shuttle/escape)
"pl" = (
/obj/structure/chair/comfy/shuttle{
	dir = 4
	},
/turf/open/floor/mineral/titanium/tiled,
/area/shuttle/escape)
"pN" = (
/obj/item/clothing/suit/hazardvest{
	desc = "A high-visibility lifejacket complete with whistle and slot for oxygen tanks.";
	name = "emergency lifejacket"
	},
/obj/item/clothing/suit/hazardvest{
	desc = "A high-visibility lifejacket complete with whistle and slot for oxygen tanks.";
	name = "emergency lifejacket"
	},
/obj/item/clothing/suit/hazardvest{
	desc = "A high-visibility lifejacket complete with whistle and slot for oxygen tanks.";
	name = "emergency lifejacket"
	},
/obj/item/clothing/suit/hazardvest{
	desc = "A high-visibility lifejacket complete with whistle and slot for oxygen tanks.";
	name = "emergency lifejacket"
	},
/obj/item/clothing/suit/hazardvest{
	desc = "A high-visibility lifejacket complete with whistle and slot for oxygen tanks.";
	name = "emergency lifejacket"
	},
/obj/item/tank/internals/emergency_oxygen{
	pixel_x = 3
	},
/obj/item/tank/internals/emergency_oxygen{
	pixel_x = 3
	},
/obj/item/tank/internals/emergency_oxygen{
	pixel_x = 3
	},
/obj/item/tank/internals/emergency_oxygen{
	pixel_x = 3
	},
/obj/item/tank/internals/emergency_oxygen{
	pixel_x = 3
	},
/obj/item/clothing/mask/breath{
	pixel_x = -3;
	pixel_y = -3
	},
/obj/item/clothing/mask/breath{
	pixel_x = -3;
	pixel_y = -3
	},
/obj/item/clothing/mask/breath{
	pixel_x = -3;
	pixel_y = -3
	},
/obj/item/clothing/mask/breath{
	pixel_x = -3;
	pixel_y = -3
	},
/obj/item/clothing/mask/breath{
	pixel_x = -3;
	pixel_y = -3
	},
/obj/item/clothing/head/hardhat/orange{
	name = "protective hat";
	pixel_y = 9
	},
/obj/item/clothing/head/hardhat/orange{
	name = "protective hat";
	pixel_y = 9
	},
/obj/item/clothing/head/hardhat/orange{
	name = "protective hat";
	pixel_y = 9
	},
/obj/item/clothing/head/hardhat/orange{
	name = "protective hat";
	pixel_y = 9
	},
/obj/item/clothing/head/hardhat/orange{
	name = "protective hat";
	pixel_y = 9
	},
/obj/structure/closet/crate/internals,
/obj/machinery/light,
/turf/open/floor/mineral/plastitanium,
/area/shuttle/escape)
"pR" = (
/obj/effect/turf_decal/siding/red{
	dir = 8
	},
/obj/effect/turf_decal/siding/yellow{
	dir = 4
	},
/turf/open/floor/mineral/titanium/white,
/area/shuttle/escape)
"pV" = (
/obj/effect/turf_decal/siding/purple{
	color = "#4D0067";
	dir = 1
	},
/turf/open/floor/mineral/titanium/white,
/area/shuttle/escape)
"qc" = (
/obj/structure/sink{
	dir = 4;
	pixel_x = -11
	},
/turf/open/floor/mineral/titanium/blue,
/area/shuttle/escape)
"qn" = (
/obj/machinery/suit_storage_unit/standard_unit,
/turf/open/floor/mineral/plastitanium,
/area/shuttle/escape)
"qV" = (
/obj/structure/shuttle/engine/propulsion{
	dir = 1
	},
/turf/open/floor/plating,
/area/shuttle/escape)
"rd" = (
/obj/machinery/door/airlock/titanium,
/obj/docking_port/mobile/emergency{
	dir = 8
	},
/turf/open/floor/mineral/titanium/white,
/area/shuttle/escape)
"rT" = (
/obj/structure/toilet{
	dir = 1
	},
/obj/machinery/light/small{
	dir = 8
	},
/turf/open/floor/mineral/titanium/white,
/area/shuttle/escape)
"sp" = (
/turf/open/floor/mineral/titanium/blue,
/area/shuttle/escape)
"sX" = (
/obj/machinery/computer/crew{
	dir = 8
	},
/turf/open/floor/mineral/titanium/white,
/area/shuttle/escape)
"ta" = (
/obj/machinery/computer/operating{
	dir = 4
	},
/obj/machinery/light{
	dir = 8
	},
/turf/open/floor/mineral/titanium/white,
/area/shuttle/escape)
"tl" = (
/obj/structure/reagent_dispensers/fueltank,
/turf/open/floor/mineral/titanium/yellow,
/area/shuttle/escape)
"uc" = (
/obj/effect/turf_decal/siding/yellow,
/turf/open/floor/mineral/titanium/white,
/area/shuttle/escape)
"vl" = (
/turf/open/floor/mineral/plastitanium,
/area/shuttle/escape)
"vr" = (
/obj/structure/chair/comfy/shuttle{
	dir = 4
	},
/turf/open/floor/mineral/plastitanium/red/brig,
/area/shuttle/escape/brig)
"vt" = (
/obj/machinery/light{
	dir = 8
	},
/turf/open/floor/mineral/titanium,
/area/shuttle/escape)
"vE" = (
/obj/structure/chair/comfy/shuttle,
/turf/open/floor/mineral/titanium/tiled,
/area/shuttle/escape)
"wu" = (
/obj/effect/turf_decal/siding/red{
	dir = 4
	},
/turf/open/floor/mineral/titanium/white,
/area/shuttle/escape)
"wM" = (
/obj/effect/turf_decal/siding/purple/corner{
	color = "#4D0067";
	dir = 8
	},
/turf/open/floor/mineral/titanium/white,
/area/shuttle/escape)
"wR" = (
/obj/machinery/door/airlock/command/glass{
	name = "Cockpit";
	req_access_txt = "19"
	},
/turf/open/floor/mineral/titanium,
/area/shuttle/escape)
"xs" = (
/obj/machinery/light{
	dir = 8
	},
/turf/open/floor/mineral/titanium/white,
/area/shuttle/escape)
"xA" = (
/turf/open/floor/mineral/titanium,
/area/shuttle/escape)
"zV" = (
/obj/machinery/computer/emergency_shuttle{
	dir = 1
	},
/turf/open/floor/mineral/titanium/white,
/area/shuttle/escape)
"Aa" = (
/obj/structure/table/reinforced,
/obj/item/storage/firstaid/fire,
/obj/item/storage/firstaid/regular{
	pixel_x = 2;
	pixel_y = 3
	},
/turf/open/floor/mineral/titanium/blue,
/area/shuttle/escape)
"Aj" = (
/obj/structure/shuttle/engine/propulsion/burst/left{
	dir = 1
	},
/turf/open/floor/plating,
/area/shuttle/escape)
"Ap" = (
/obj/structure/extinguisher_cabinet{
	pixel_y = 32
	},
/turf/open/floor/mineral/titanium/yellow,
/area/shuttle/escape)
"Az" = (
/obj/machinery/door/airlock/shuttle{
	name = "Emergency Shuttle Cargo"
	},
/turf/open/floor/mineral/titanium/yellow,
/area/shuttle/escape)
"AF" = (
/obj/structure/table/reinforced,
/obj/machinery/recharger,
/turf/open/floor/mineral/plastitanium/red/brig,
/area/shuttle/escape/brig)
"BR" = (
/obj/effect/turf_decal/siding/green,
/turf/open/floor/mineral/titanium/white,
/area/shuttle/escape)
"Cg" = (
/obj/structure/sign/directions/security,
/turf/closed/wall/mineral/titanium,
/area/shuttle/escape)
"Df" = (
/obj/machinery/door/airlock/external{
	name = "Emergency Recovery Airlock"
	},
/turf/open/floor/mineral/plastitanium,
/area/shuttle/escape)
"Dn" = (
/obj/structure/chair/comfy/shuttle{
	dir = 8
	},
/turf/open/floor/mineral/plastitanium/red/brig,
/area/shuttle/escape/brig)
"Eh" = (
/obj/effect/turf_decal/siding/yellow,
/obj/structure/extinguisher_cabinet{
	pixel_y = 32
	},
/turf/open/floor/mineral/titanium/white,
/area/shuttle/escape)
"Fa" = (
/obj/machinery/portable_atmospherics/canister/oxygen,
/turf/open/floor/mineral/plastitanium,
/area/shuttle/escape)
"Fn" = (
/obj/structure/rack,
/obj/item/storage/toolbox/electrical{
	pixel_x = -3;
	pixel_y = 1
	},
/obj/item/storage/toolbox/mechanical{
	pixel_y = -1
	},
/obj/item/storage/toolbox/emergency{
	pixel_x = 3;
	pixel_y = -5
	},
/turf/open/floor/mineral/plastitanium,
/area/shuttle/escape)
"Gg" = (
/obj/structure/chair/comfy/shuttle{
	dir = 8
	},
/turf/open/floor/mineral/titanium/tiled,
/area/shuttle/escape)
"Gj" = (
/obj/effect/turf_decal/siding/yellow{
	dir = 1
	},
/obj/machinery/light,
/turf/open/floor/mineral/titanium/white,
/area/shuttle/escape)
"GP" = (
/turf/open/floor/mineral/titanium/white,
/area/shuttle/escape)
"Ho" = (
/obj/effect/turf_decal/siding/red/corner{
	dir = 4
	},
/obj/machinery/light{
	dir = 8
	},
/turf/open/floor/mineral/titanium/white,
/area/shuttle/escape)
"HY" = (
/turf/open/floor/mineral/titanium/tiled,
/area/shuttle/escape)
"Ic" = (
/obj/effect/spawner/structure/window/shuttle,
/turf/open/floor/plating,
/area/shuttle/escape)
"Iv" = (
/obj/effect/turf_decal/siding/purple{
	color = "#4D0067"
	},
/turf/open/floor/mineral/titanium/white,
/area/shuttle/escape)
"IE" = (
/obj/structure/table/optable,
/turf/open/floor/mineral/titanium/blue,
/area/shuttle/escape)
"Js" = (
/obj/effect/turf_decal/siding/red/corner{
	dir = 1
	},
/obj/effect/turf_decal/siding/yellow/corner{
	dir = 4
	},
/turf/open/floor/mineral/titanium/white,
/area/shuttle/escape)
"JG" = (
/obj/machinery/door/airlock/medical/glass{
	name = "Escape Shuttle Infirmary"
	},
/turf/open/floor/mineral/titanium/blue,
/area/shuttle/escape)
"KJ" = (
/obj/structure/window/reinforced{
	dir = 8;
	pixel_x = -4
	},
/obj/structure/chair/comfy/shuttle{
	dir = 4
	},
/turf/open/floor/glass/reinforced,
/area/shuttle/escape)
"KY" = (
/obj/machinery/computer/communications{
	dir = 8
	},
/turf/open/floor/mineral/titanium/tiled,
/area/shuttle/escape)
"Lh" = (
/obj/effect/turf_decal/siding/green/corner{
	dir = 8
	},
/obj/effect/turf_decal/siding/purple/corner{
	color = "#4D0067"
	},
/turf/open/floor/mineral/titanium/white,
/area/shuttle/escape)
"LP" = (
/obj/machinery/computer/security{
	dir = 4
	},
/turf/open/floor/mineral/titanium/white,
/area/shuttle/escape)
"MA" = (
/obj/machinery/shieldgen,
/turf/open/floor/mineral/titanium/tiled,
/area/shuttle/escape)
"Nf" = (
/obj/structure/shuttle/engine/propulsion/burst/right{
	dir = 1
	},
/turf/open/floor/plating,
/area/shuttle/escape)
"NI" = (
/obj/machinery/shower{
	dir = 8;
	name = "emergency shower";
	pixel_y = -4
	},
/mob/living/simple_animal/bot/medbot{
	name = "\improper emergency medibot";
	pixel_x = -3;
	pixel_y = 2
	},
/turf/open/floor/mineral/titanium/blue,
/area/shuttle/escape)
"Oa" = (
/obj/structure/chair/comfy/shuttle,
/turf/open/floor/mineral/plastitanium/red/brig,
/area/shuttle/escape/brig)
"Ot" = (
/obj/effect/turf_decal/siding/red/corner,
/turf/open/floor/mineral/titanium/white,
/area/shuttle/escape)
"OB" = (
/obj/structure/sign/directions/supply,
/turf/closed/wall/mineral/titanium,
/area/shuttle/escape)
"OP" = (
/obj/machinery/door/airlock/command/glass{
	name = "Cockpit";
	req_one_access_txt = "2;19"
	},
/turf/open/floor/mineral/titanium,
/area/shuttle/escape)
"Pa" = (
/obj/machinery/light{
	dir = 4
	},
/turf/open/floor/mineral/plastitanium/red/brig,
/area/shuttle/escape/brig)
"Pg" = (
/obj/structure/chair/comfy/shuttle{
	dir = 1
	},
/turf/open/floor/mineral/plastitanium,
/area/shuttle/escape)
"Pt" = (
/obj/effect/turf_decal/siding/red{
	dir = 1
	},
/turf/open/floor/mineral/titanium/white,
/area/shuttle/escape)
"PJ" = (
/obj/structure/reagent_dispensers/watertank,
/turf/open/floor/mineral/titanium/yellow,
/area/shuttle/escape)
"PT" = (
/obj/structure/sign/directions/science,
/turf/closed/wall/mineral/titanium,
/area/shuttle/escape)
"QD" = (
/obj/effect/turf_decal/siding/red,
/turf/open/floor/mineral/titanium/white,
/area/shuttle/escape)
"QL" = (
/turf/template_noop,
/area/template_noop)
"Rz" = (
/obj/structure/table/reinforced,
/obj/item/storage/firstaid/toxin,
/obj/item/storage/firstaid/o2{
	pixel_x = 3;
	pixel_y = 3
	},
/turf/open/floor/mineral/titanium/blue,
/area/shuttle/escape)
"Sm" = (
/obj/effect/turf_decal/siding/purple{
	color = "#4D0067"
	},
/obj/machinery/light{
	dir = 1
	},
/turf/open/floor/mineral/titanium/white,
/area/shuttle/escape)
"SE" = (
/obj/effect/turf_decal/siding/purple{
	color = "#4D0067";
	dir = 8
	},
/turf/open/floor/mineral/titanium/white,
/area/shuttle/escape)
"SY" = (
/obj/machinery/door/airlock,
/turf/open/floor/mineral/titanium/white,
/area/shuttle/escape)
"TR" = (
/obj/effect/turf_decal/siding/green{
	dir = 1
	},
/turf/open/floor/mineral/titanium/white,
/area/shuttle/escape)
"Uq" = (
/obj/effect/turf_decal/siding/red/corner{
	dir = 8
	},
/obj/effect/turf_decal/siding/yellow/corner,
/turf/open/floor/mineral/titanium/white,
/area/shuttle/escape)
"UE" = (
/obj/structure/chair/comfy/shuttle{
	dir = 8
	},
/turf/open/floor/mineral/titanium/white,
/area/shuttle/escape)
"Vz" = (
/obj/machinery/door/airlock/titanium,
/turf/open/floor/mineral/titanium/white,
/area/shuttle/escape)
"VT" = (
/turf/open/floor/mineral/titanium/yellow,
/area/shuttle/escape)
"Xh" = (
/obj/effect/turf_decal/siding/yellow{
	dir = 8
	},
/obj/effect/turf_decal/siding/green{
	dir = 4
	},
/turf/open/floor/mineral/titanium/white,
/area/shuttle/escape)
"Xp" = (
/obj/machinery/stasis,
/turf/open/floor/mineral/titanium/white,
/area/shuttle/escape)
"XP" = (
/obj/structure/closet/emcloset/anchored,
/turf/open/floor/mineral/titanium/white,
/area/shuttle/escape)
"YX" = (
/obj/structure/table/reinforced,
/obj/machinery/recharger,
/turf/open/floor/mineral/titanium/white,
/area/shuttle/escape)
"Zt" = (
/obj/machinery/light,
/turf/open/floor/mineral/titanium/yellow,
/area/shuttle/escape)
"Zu" = (
/obj/structure/shuttle/engine/heater{
	dir = 1
	},
/obj/structure/window/reinforced,
/turf/open/floor/plating,
/area/shuttle/escape)

(1,1,1) = {"
QL
QL
QL
QL
jB
jB
jB
jB
jB
jB
Ic
Ic
Ic
Ic
jB
jB
jB
Ic
Ic
Ic
jB
jB
QL
QL
QL
QL
QL
QL
"}
(2,1,1) = {"
jB
jB
Df
jB
jB
GP
SY
rT
jB
Ot
wu
wu
wu
wu
Ho
Ic
kK
qc
ta
IE
lQ
jB
QL
QL
QL
QL
QL
QL
"}
(3,1,1) = {"
Nf
Zu
vl
qn
jB
GP
jB
jB
jB
QD
cf
cf
cf
cf
Pt
Ic
Rz
GP
sp
GP
Aa
jB
Ic
jB
QL
QL
QL
QL
"}
(4,1,1) = {"
Nf
Zu
vl
qn
jB
GP
SY
fx
Cg
bh
KJ
KJ
KJ
KJ
Pt
JG
GP
sp
GP
sp
GP
jB
MA
Ic
QL
QL
QL
QL
"}
(5,1,1) = {"
Nf
Zu
vl
qn
jB
GP
jB
jB
jB
Uq
pR
pR
pR
pR
Js
Ic
dw
Xp
NI
Xp
dw
jB
HY
nv
jB
jB
jB
QL
"}
(6,1,1) = {"
qV
Zu
vl
pN
jB
gP
GP
GP
jB
Eh
cf
cf
cf
cf
Gj
nv
jB
jB
jB
Ic
jB
jB
GP
xs
eP
LP
Ic
Ic
"}
(7,1,1) = {"
qV
Zu
vl
Fa
jB
GP
aj
aj
nO
uc
KJ
KJ
KJ
KJ
ka
GP
GP
Ic
vt
xA
Ic
GP
GP
HY
Gg
UE
YX
Ic
"}
(8,1,1) = {"
qV
Zu
vl
Pg
jB
Vz
jB
jB
jB
nl
Xh
Xh
Xh
Xh
mp
GP
GP
OP
xA
xA
wR
GP
HY
HY
HY
vE
zV
Ic
"}
(9,1,1) = {"
qV
Zu
vl
Pg
jB
VT
tl
PJ
jB
BR
cf
cf
cf
cf
TR
GP
XP
Ic
xA
xA
Ic
HY
HY
HY
pl
pl
YX
Ic
"}
(10,1,1) = {"
qV
Zu
vl
nE
jB
Ap
VT
VT
OB
BR
KJ
KJ
KJ
KJ
TR
fL
nv
jB
oj
Ic
jB
jB
HY
aX
KY
sX
Ic
Ic
"}
(11,1,1) = {"
Aj
Zu
vl
vl
ou
VT
VT
VT
Az
Lh
kS
kS
kS
kS
az
GP
jB
Oa
ii
vr
AF
jB
HY
nv
jB
jB
jB
QL
"}
(12,1,1) = {"
Aj
Zu
vl
Fn
jB
ld
ld
Zt
jB
Sm
cf
cf
cf
cf
pV
GP
jB
Oa
ii
ii
aH
jB
MA
Ic
QL
QL
QL
QL
"}
(13,1,1) = {"
Aj
Zu
vl
oI
jB
aq
VT
VT
PT
Iv
KJ
KJ
KJ
KJ
pV
GP
jB
Oa
ii
ii
aH
jB
Ic
jB
QL
QL
QL
QL
"}
(14,1,1) = {"
jB
jB
Df
jB
jB
cD
VT
VT
jB
wM
SE
SE
SE
SE
no
GP
jB
ii
Pa
Dn
bb
jB
QL
QL
QL
QL
QL
QL
"}
(15,1,1) = {"
QL
QL
QL
QL
jB
jB
jB
Az
jB
Vz
jB
Ic
Ic
Ic
jB
rd
jB
oj
jB
Ic
Ic
jB
QL
QL
QL
QL
QL
QL
"}
