"a" = (/obj/structure/cable,/turf/open/indestructible/hotelwood,/area/centcom/heretic_sacrifice/fool)
"b" = (/obj/structure/table/wood,/obj/machinery/computer/records/medical/laptop,/turf/open/floor/iron/kitchen/small,/area/centcom/heretic_sacrifice/fool)
"d" = (/obj/structure/cable,/turf/open/floor/plating/rust,/area/centcom/heretic_sacrifice/fool)
"e" = (/obj/machinery/stove,/turf/open/floor/iron/kitchen/small,/area/centcom/heretic_sacrifice/fool)
"f" = (/obj/item/flashlight/flare/candle/infinite,/obj/machinery/light/very_dim/directional/south,/turf/open/floor/plating/rust,/area/centcom/heretic_sacrifice/fool)
"g" = (/mob/living/basic/bat,/obj/item/flashlight/flare/candle/infinite,/obj/machinery/light/very_dim/directional/south,/turf/open/floor/plating/rust,/area/centcom/heretic_sacrifice/fool)
"h" = (/obj/machinery/light/very_dim/directional/north,/obj/structure/cable,/turf/open/floor/plating/rust,/area/centcom/heretic_sacrifice/fool)
"i" = (/turf/open/floor/plating/rust,/area/centcom/heretic_sacrifice/fool)
"j" = (/mob/living/basic/bat,/obj/item/flashlight/flare/candle/infinite,/turf/open/floor/iron/kitchen/small,/area/centcom/heretic_sacrifice/fool)
"k" = (/turf/closed/indestructible/paper,/area/space)
"l" = (/turf/closed/indestructible/rock,/area/space)
"m" = (/turf/closed/indestructible/fakeglass,/area/space)
"n" = (/obj/machinery/light/very_dim/directional/east,/turf/open/floor/plating/rust,/area/centcom/heretic_sacrifice/fool)
"o" = (/turf/open/indestructible/hotelwood,/area/centcom/heretic_sacrifice/fool)
"r" = (/obj/item/chair/greyscale,/turf/open/indestructible/hotelwood,/area/centcom/heretic_sacrifice/fool)
"u" = (/obj/machinery/shower,/turf/open/floor/iron/kitchen/small,/area/centcom/heretic_sacrifice/fool)
"w" = (/turf/closed/indestructible/paper,/area/centcom/heretic_sacrifice/fool)
"x" = (/turf/closed/indestructible/fakedoor,/area/centcom/heretic_sacrifice/fool)
"y" = (/obj/structure/cable,/turf/open/floor/iron/kitchen/small,/area/centcom/heretic_sacrifice/fool)
"z" = (/obj/structure/cable,/turf/closed/indestructible/rock,/area/space)
"B" = (/mob/living/basic/bat,/obj/structure/cable,/turf/open/floor/plating/rust,/area/centcom/heretic_sacrifice/fool)
"C" = (/turf/closed/indestructible/rock,/area/centcom/heretic_sacrifice/fool)
"D" = (/mob/living/basic/bat,/obj/machinery/light/very_dim/directional/north,/turf/open/floor/plating/rust,/area/centcom/heretic_sacrifice/fool)
"E" = (/obj/machinery/light/very_dim/directional/east,/turf/open/floor/iron/kitchen/small,/area/centcom/heretic_sacrifice/fool)
"F" = (/obj/item/flashlight/flare/candle/infinite,/obj/machinery/light/very_dim/directional/west,/turf/open/floor/iron/kitchen/small,/area/centcom/heretic_sacrifice/fool)
"G" = (/obj/structure/cable,/turf/closed/indestructible/fakeglass,/area/centcom/heretic_sacrifice/fool)
"H" = (/obj/structure/closet/mini_fridge/grimy,/turf/open/floor/iron/kitchen/small,/area/centcom/heretic_sacrifice/fool)
"K" = (/turf/open/space/basic,/area/space)
"M" = (/turf/open/floor/iron/kitchen/small,/area/centcom/heretic_sacrifice/fool)
"N" = (/turf/open/space/basic,/area/centcom/heretic_sacrifice/fool)
"P" = (/mob/living/basic/bat,/obj/structure/cable,/turf/open/floor/iron/kitchen/small,/area/centcom/heretic_sacrifice/fool)
"Q" = (/obj/effect/landmark/heretic/fool,/turf/open/indestructible/hotelwood,/area/centcom/heretic_sacrifice/fool)
"R" = (/obj/machinery/washing_machine,/obj/structure/cable,/turf/open/floor/iron/kitchen/small,/area/centcom/heretic_sacrifice/fool)
"S" = (/mob/living/basic/bat,/obj/machinery/light/very_dim/directional/west,/turf/open/floor/plating/rust,/area/centcom/heretic_sacrifice/fool)
"T" = (/mob/living/basic/bat,/turf/open/indestructible/hotelwood,/area/centcom/heretic_sacrifice/fool)
"V" = (/mob/living/basic/bat,/obj/structure/sink,/obj/structure/cable,/turf/open/floor/plating/rust,/area/centcom/heretic_sacrifice/fool)
"W" = (/mob/living/basic/bat,/obj/structure/toilet/greyscale,/turf/open/floor/iron/kitchen/small,/area/centcom/heretic_sacrifice/fool)
"Y" = (/turf/closed/indestructible/fakeglass,/area/centcom/heretic_sacrifice/fool)
"Z" = (/turf/closed/indestructible/fakedoor,/area/space)

(1,1,1) = {"
KKKKKKKKKKKKKK
KllZllllzzZllK
NCiTDWuRVhTilK
NxooMMMMyMooZK
NCFoyMMMMioElK
NCeodiMMMMrblK
NCHooooQoooPlK
NCjoooooooodmk
NCModdaoydaBmk
NCSoiyooMionlK
NxooMMooMMooZK
NCMyBfoogMMMlK
NCCYGCxxCYYClK
NNNwwNNNNwwNKK
"}
