//MAP CONVERTED BY dmm2tgm.py THIS HEADER COMMENT PREVENTS RECONVERSION, DO NOT REMOVE
"aa" = (
/turf/template_noop,
/area/template_noop)
"ab" = (
/obj/effect/spawner/structure/window/reinforced,
/obj/machinery/door/poddoor/preopen{
	id = "techcult_window"
	},
/turf/open/floor/plating,
/area/ruin/powered/mechanicus)
"ac" = (
/turf/open/floor/iron/grimy,
/area/ruin/powered/mechanicus)
"af" = (
/obj/effect/mob_spawn/human/techcult/leader,
/turf/open/floor/iron/grimy,
/area/ruin/powered/mechanicus)
"ag" = (
/obj/structure/table/wood/fancy/black,
/obj/item/storage/book/bible/omnissiah,
/turf/open/floor/iron/grimy,
/area/ruin/powered/mechanicus)
"ai" = (
/obj/effect/turf_decal/tile/purple{
	dir = 1
	},
/obj/effect/turf_decal/tile/purple{
	dir = 4
	},
/turf/open/floor/iron/dark,
/area/ruin/powered/mechanicus)
"al" = (
/obj/structure/mirror{
	pixel_y = 32
	},
/obj/effect/turf_decal/tile/purple{
	dir = 1
	},
/obj/effect/turf_decal/tile/purple{
	dir = 4
	},
/turf/open/floor/iron/dark,
/area/ruin/powered/mechanicus)
"am" = (
/obj/machinery/button/door{
	id = "techcult_window";
	name = "Window Shutters";
	pixel_x = -26;
	pixel_y = 6
	},
/obj/machinery/light_switch{
	pixel_x = -24;
	pixel_y = -6
	},
/turf/open/floor/iron/grimy,
/area/ruin/powered/mechanicus)
"an" = (
/obj/structure/table/wood/fancy/black,
/turf/open/floor/iron/grimy,
/area/ruin/powered/mechanicus)
"ao" = (
/obj/structure/table/wood/fancy/black,
/obj/item/storage/fancy/candle_box{
	pixel_x = 4;
	pixel_y = 4
	},
/obj/item/storage/fancy/candle_box{
	pixel_x = -4
	},
/turf/open/floor/iron/grimy,
/area/ruin/powered/mechanicus)
"ar" = (
/obj/structure/fence{
	dir = 4
	},
/turf/open/floor/plating/asteroid/basalt/lava_land_surface,
/area/ruin/powered/mechanicus)
"as" = (
/obj/structure/fence/corner,
/obj/structure/fence,
/turf/open/floor/plating/asteroid/basalt/lava_land_surface,
/area/ruin/powered/mechanicus)
"at" = (
/obj/machinery/mecha_part_fabricator,
/obj/effect/turf_decal/tile/purple{
	dir = 4
	},
/obj/effect/turf_decal/tile/purple{
	dir = 1
	},
/obj/effect/turf_decal/tile/purple{
	dir = 8
	},
/turf/open/floor/iron/dark,
/area/ruin/powered/mechanicus)
"au" = (
/obj/effect/turf_decal/tile/green{
	dir = 1
	},
/obj/effect/turf_decal/tile/green{
	dir = 8
	},
/obj/effect/turf_decal/tile/green{
	dir = 4
	},
/turf/open/floor/iron/dark,
/area/ruin/powered/mechanicus)
"av" = (
/obj/structure/table,
/obj/machinery/cell_charger,
/obj/item/stock_parts/cell/high,
/obj/effect/turf_decal/tile/purple{
	dir = 1
	},
/obj/effect/turf_decal/tile/purple{
	dir = 4
	},
/obj/effect/turf_decal/tile/purple,
/turf/open/floor/iron/dark,
/area/ruin/powered/mechanicus)
"aw" = (
/obj/machinery/light{
	dir = 4;
	icon_state = "tube"
	},
/turf/open/floor/iron/grimy,
/area/ruin/powered/mechanicus)
"ay" = (
/obj/structure/bed/pod,
/obj/effect/mob_spawn/human/techcult{
	dir = 8;
	icon_state = "sleeper"
	},
/obj/effect/turf_decal/tile/green{
	dir = 1
	},
/obj/effect/turf_decal/tile/green,
/obj/effect/turf_decal/tile/green{
	dir = 4
	},
/turf/open/floor/iron/dark,
/area/ruin/powered/mechanicus)
"az" = (
/obj/machinery/hydroponics/soil,
/turf/open/floor/plating/asteroid/basalt/lava_land_surface,
/area/ruin/powered/mechanicus)
"aA" = (
/obj/machinery/light{
	dir = 8;
	icon_state = "tube"
	},
/turf/open/floor/circuit,
/area/ruin/powered/mechanicus)
"aB" = (
/obj/machinery/conveyor_switch/oneway{
	id = "techcult_fab"
	},
/turf/open/floor/iron/dark,
/area/ruin/powered/mechanicus)
"aC" = (
/turf/open/floor/plating/asteroid/basalt/lava_land_surface,
/area/ruin/powered/mechanicus)
"aD" = (
/obj/structure/fence,
/turf/open/floor/plating/asteroid/basalt/lava_land_surface,
/area/ruin/powered/mechanicus)
"aH" = (
/obj/machinery/conveyor{
	id = "techcult_fab"
	},
/obj/effect/turf_decal/bot,
/obj/effect/turf_decal/tile/purple{
	dir = 8
	},
/obj/effect/turf_decal/tile/purple{
	dir = 1
	},
/turf/open/floor/iron/dark,
/area/ruin/powered/mechanicus)
"aI" = (
/obj/machinery/conveyor{
	id = "techcult_fab"
	},
/obj/effect/turf_decal/bot,
/turf/open/floor/iron/dark,
/area/ruin/powered/mechanicus)
"aJ" = (
/obj/structure/table,
/obj/item/stock_parts/cell/high{
	pixel_x = 4;
	pixel_y = 4
	},
/obj/item/stock_parts/cell/high{
	pixel_x = -4;
	pixel_y = -4
	},
/obj/item/stock_parts/cell/high{
	pixel_x = 4;
	pixel_y = -4
	},
/obj/item/stock_parts/cell/high{
	pixel_x = -4;
	pixel_y = 4
	},
/obj/effect/turf_decal/tile/purple{
	dir = 4
	},
/turf/open/floor/iron/dark,
/area/ruin/powered/mechanicus)
"aL" = (
/obj/structure/table/wood,
/obj/machinery/light/small{
	dir = 4;
	icon_state = "bulb"
	},
/obj/effect/turf_decal/tile/green{
	dir = 8
	},
/obj/effect/turf_decal/tile/green,
/obj/effect/turf_decal/tile/green{
	dir = 4
	},
/turf/open/floor/iron/dark,
/area/ruin/powered/mechanicus)
"aO" = (
/obj/machinery/light{
	dir = 8;
	icon_state = "tube"
	},
/turf/open/floor/iron/grimy,
/area/ruin/powered/mechanicus)
"aS" = (
/obj/effect/mapping_helpers/no_lava,
/obj/effect/turf_decal/trimline/red/filled/line{
	dir = 1;
	icon_state = "trimline_fill"
	},
/turf/open/floor/plating/asteroid/basalt/lava_land_surface,
/area/ruin/powered/mechanicus)
"aT" = (
/obj/effect/turf_decal/tile/blue{
	dir = 8
	},
/turf/open/floor/iron/dark,
/area/ruin/powered/mechanicus)
"aU" = (
/obj/effect/turf_decal/tile/blue{
	dir = 1
	},
/obj/effect/turf_decal/tile/blue,
/obj/effect/turf_decal/tile/blue{
	dir = 4
	},
/turf/open/floor/iron/dark,
/area/ruin/powered/mechanicus)
"aV" = (
/turf/closed/wall,
/area/ruin/powered/mechanicus)
"aW" = (
/obj/machinery/door/airlock{
	name = "Personal Room";
	req_access = 220
	},
/turf/open/floor/iron/dark,
/area/ruin/powered/mechanicus)
"aX" = (
/turf/open/floor/circuit,
/area/ruin/powered/mechanicus)
"aY" = (
/obj/effect/turf_decal/tile/brown{
	dir = 1
	},
/obj/effect/turf_decal/tile/brown{
	dir = 4
	},
/obj/effect/turf_decal/tile/brown{
	dir = 8
	},
/obj/structure/frame/machine{
	anchored = 1
	},
/obj/item/circuitboard/machine/ore_silo,
/obj/item/stack/cable_coil/five,
/turf/open/floor/iron/dark,
/area/ruin/powered/mechanicus)
"aZ" = (
/obj/effect/turf_decal/tile/brown{
	dir = 1
	},
/obj/effect/turf_decal/tile/brown{
	dir = 4
	},
/obj/machinery/rnd/production/protolathe,
/turf/open/floor/iron/dark,
/area/ruin/powered/mechanicus)
"ba" = (
/obj/effect/turf_decal/tile/brown{
	dir = 1
	},
/obj/effect/turf_decal/tile/brown{
	dir = 4
	},
/obj/machinery/autolathe,
/turf/open/floor/iron/dark,
/area/ruin/powered/mechanicus)
"bb" = (
/obj/effect/turf_decal/tile/brown{
	dir = 1
	},
/obj/effect/turf_decal/tile/brown{
	dir = 4
	},
/obj/effect/turf_decal/delivery,
/turf/open/floor/iron/dark,
/area/ruin/powered/mechanicus)
"bc" = (
/obj/machinery/computer/mech_bay_power_console{
	dir = 8;
	icon_state = "computer"
	},
/obj/machinery/light{
	dir = 4;
	icon_state = "tube"
	},
/obj/effect/turf_decal/tile/purple,
/turf/open/floor/iron/dark,
/area/ruin/powered/mechanicus)
"bd" = (
/obj/effect/mapping_helpers/no_lava,
/obj/machinery/light/small{
	dir = 1;
	icon_state = "bulb"
	},
/obj/effect/turf_decal/trimline/red/filled/line{
	dir = 1;
	icon_state = "trimline_fill"
	},
/turf/open/floor/plating/asteroid/basalt/lava_land_surface,
/area/ruin/powered/mechanicus)
"be" = (
/turf/open/lava/smooth/lava_land_surface,
/area/lavaland/surface/outdoors)
"bf" = (
/obj/effect/mapping_helpers/no_lava,
/turf/open/floor/plating/asteroid/basalt/lava_land_surface,
/area/lavaland/surface/outdoors)
"bg" = (
/obj/effect/turf_decal/trimline/red/line{
	dir = 9;
	icon_state = "trimline"
	},
/obj/machinery/mineral/equipment_vendor,
/turf/open/floor/iron/dark,
/area/ruin/powered/mechanicus)
"bh" = (
/obj/structure/table,
/obj/item/t_scanner/adv_mining_scanner/lesser,
/obj/item/t_scanner/adv_mining_scanner/lesser,
/obj/item/t_scanner/adv_mining_scanner/lesser,
/obj/item/t_scanner/adv_mining_scanner/lesser,
/obj/item/t_scanner/adv_mining_scanner/lesser,
/obj/machinery/light/small{
	dir = 1;
	icon_state = "bulb"
	},
/obj/effect/turf_decal/trimline/red/line{
	dir = 1;
	icon_state = "trimline"
	},
/turf/open/floor/iron/dark,
/area/ruin/powered/mechanicus)
"bj" = (
/obj/effect/turf_decal/trimline/red/line{
	dir = 1;
	icon_state = "trimline"
	},
/turf/open/floor/iron/dark,
/area/ruin/powered/mechanicus)
"bk" = (
/obj/effect/turf_decal/trimline/red/line{
	dir = 1;
	icon_state = "trimline"
	},
/obj/structure/extinguisher_cabinet{
	pixel_y = 32
	},
/turf/open/floor/iron/dark,
/area/ruin/powered/mechanicus)
"bl" = (
/obj/structure/table,
/obj/item/pickaxe/mini,
/obj/item/pickaxe/mini,
/obj/item/pickaxe/mini,
/obj/item/pickaxe/mini,
/obj/item/pickaxe/mini,
/obj/effect/turf_decal/trimline/red/line{
	dir = 1;
	icon_state = "trimline"
	},
/turf/open/floor/iron/dark,
/area/ruin/powered/mechanicus)
"bn" = (
/obj/machinery/computer/operating{
	dir = 1;
	icon_state = "computer"
	},
/obj/effect/turf_decal/tile/blue{
	dir = 8
	},
/obj/effect/turf_decal/tile/blue,
/obj/effect/turf_decal/tile/blue{
	dir = 4
	},
/turf/open/floor/iron/dark,
/area/ruin/powered/mechanicus)
"bo" = (
/obj/structure/table/glass,
/obj/item/storage/firstaid/fire{
	pixel_x = -6;
	pixel_y = 6
	},
/obj/item/storage/firstaid/brute{
	pixel_x = 6;
	pixel_y = -6
	},
/obj/item/storage/firstaid/regular{
	pixel_x = -6;
	pixel_y = -6
	},
/obj/item/storage/firstaid/o2{
	layer = 2.999;
	pixel_x = 6;
	pixel_y = 6
	},
/turf/open/floor/circuit,
/area/ruin/powered/mechanicus)
"bp" = (
/obj/effect/turf_decal/tile/blue{
	dir = 1
	},
/obj/effect/turf_decal/tile/blue{
	dir = 4
	},
/turf/open/floor/iron/dark,
/area/ruin/powered/mechanicus)
"bq" = (
/obj/effect/turf_decal/tile/blue{
	dir = 1
	},
/obj/effect/turf_decal/tile/blue{
	dir = 8
	},
/obj/effect/turf_decal/tile/blue{
	dir = 4
	},
/turf/open/floor/iron/dark,
/area/ruin/powered/mechanicus)
"br" = (
/obj/effect/turf_decal/trimline/red/line{
	dir = 6;
	icon_state = "trimline"
	},
/turf/open/floor/iron/dark,
/area/ruin/powered/mechanicus)
"bu" = (
/obj/machinery/door/airlock/mining/glass{
	name = "Refinery";
	req_access = 220
	},
/turf/open/floor/iron/dark,
/area/ruin/powered/mechanicus)
"bv" = (
/obj/machinery/door/airlock/glass{
	name = "Dormitories";
	req_access = 220
	},
/turf/open/floor/iron/dark,
/area/ruin/powered/mechanicus)
"bw" = (
/obj/effect/turf_decal/tile/brown{
	dir = 1
	},
/obj/effect/turf_decal/tile/brown{
	dir = 8
	},
/obj/effect/turf_decal/tile/brown,
/turf/open/floor/iron/dark,
/area/ruin/powered/mechanicus)
"by" = (
/obj/effect/turf_decal/tile/brown{
	dir = 8
	},
/obj/effect/turf_decal/tile/brown,
/turf/open/floor/iron/dark,
/area/ruin/powered/mechanicus)
"bz" = (
/obj/machinery/light/small{
	dir = 1;
	icon_state = "bulb"
	},
/turf/open/floor/iron/dark,
/area/ruin/powered/mechanicus)
"bA" = (
/obj/effect/turf_decal/tile/blue{
	dir = 1
	},
/turf/open/floor/iron/dark,
/area/ruin/powered/mechanicus)
"bB" = (
/obj/machinery/door/airlock/glass{
	name = "Backyard";
	req_access = 220
	},
/obj/structure/fans/tiny,
/turf/open/floor/iron/dark,
/area/ruin/powered/mechanicus)
"bC" = (
/obj/effect/turf_decal/tile/blue{
	dir = 8
	},
/obj/effect/turf_decal/tile/blue{
	dir = 1
	},
/obj/effect/turf_decal/tile/blue,
/turf/open/floor/iron/dark,
/area/ruin/powered/mechanicus)
"bD" = (
/turf/open/floor/iron/dark,
/area/ruin/powered/mechanicus)
"bE" = (
/obj/effect/turf_decal/tile/blue,
/turf/open/floor/iron/dark,
/area/ruin/powered/mechanicus)
"bF" = (
/obj/structure/table/optable,
/turf/open/floor/circuit/green,
/area/ruin/powered/mechanicus)
"bG" = (
/obj/structure/frame/computer{
	anchored = 1;
	dir = 1;
	icon_state = "0"
	},
/obj/effect/turf_decal/tile/blue{
	dir = 8
	},
/obj/effect/turf_decal/tile/blue,
/obj/effect/turf_decal/tile/blue{
	dir = 1
	},
/turf/open/floor/iron/dark,
/area/ruin/powered/mechanicus)
"bH" = (
/obj/structure/table,
/obj/item/storage/backpack/duffelbag/med/surgery{
	pixel_y = 8
	},
/obj/item/storage/backpack/duffelbag/med/surgery,
/obj/machinery/light,
/obj/effect/turf_decal/tile/blue{
	dir = 8
	},
/obj/effect/turf_decal/tile/blue,
/turf/open/floor/iron/dark,
/area/ruin/powered/mechanicus)
"bI" = (
/obj/effect/turf_decal/tile/purple{
	dir = 8
	},
/turf/open/floor/iron/dark,
/area/ruin/powered/mechanicus)
"bJ" = (
/obj/effect/turf_decal/tile/green{
	dir = 8
	},
/obj/effect/turf_decal/tile/green,
/obj/effect/turf_decal/tile/green{
	dir = 1
	},
/turf/open/floor/iron/dark,
/area/ruin/powered/mechanicus)
"bK" = (
/obj/structure/table,
/obj/item/flashlight/lantern,
/obj/item/flashlight/lantern,
/obj/item/flashlight/lantern,
/obj/item/flashlight/lantern,
/obj/item/flashlight/lantern,
/obj/machinery/light/small{
	dir = 1;
	icon_state = "bulb"
	},
/obj/effect/turf_decal/trimline/red/line{
	dir = 1;
	icon_state = "trimline"
	},
/turf/open/floor/iron/dark,
/area/ruin/powered/mechanicus)
"bL" = (
/turf/open/floor/circuit/green,
/area/ruin/powered/mechanicus)
"bM" = (
/obj/structure/chair/wood{
	dir = 1
	},
/turf/open/floor/iron/dark,
/area/ruin/powered/mechanicus)
"bN" = (
/obj/effect/turf_decal/tile/green{
	dir = 8
	},
/obj/effect/turf_decal/tile/green{
	dir = 1
	},
/obj/effect/turf_decal/tile/green{
	dir = 4
	},
/turf/open/floor/iron/dark,
/area/ruin/powered/mechanicus)
"bO" = (
/obj/structure/rack,
/obj/item/cultivator/rake{
	pixel_x = 4;
	pixel_y = -4
	},
/obj/item/cultivator/rake,
/obj/item/cultivator/rake{
	pixel_x = -4;
	pixel_y = 4
	},
/turf/open/floor/plating/asteroid/basalt/lava_land_surface,
/area/ruin/powered/mechanicus)
"bP" = (
/obj/effect/turf_decal/tile/green{
	dir = 8
	},
/obj/effect/turf_decal/tile/green{
	dir = 1
	},
/obj/effect/turf_decal/tile/green,
/turf/open/floor/iron/dark,
/area/ruin/powered/mechanicus)
"bQ" = (
/obj/effect/turf_decal/trimline/red/line,
/turf/open/floor/iron/dark,
/area/ruin/powered/mechanicus)
"bR" = (
/obj/structure/rack,
/obj/item/shovel{
	pixel_x = 2;
	pixel_y = -2
	},
/obj/item/shovel,
/obj/item/shovel{
	pixel_x = -2;
	pixel_y = 2
	},
/turf/open/floor/plating/asteroid/basalt/lava_land_surface,
/area/ruin/powered/mechanicus)
"bS" = (
/obj/effect/spawner/structure/window/reinforced,
/turf/open/floor/plating,
/area/ruin/powered/mechanicus)
"bT" = (
/obj/structure/closet/secure_closet/mechanicus/implants,
/turf/open/floor/circuit,
/area/ruin/powered/mechanicus)
"bU" = (
/obj/item/reagent_containers/glass/bottle/nutrient/l4z,
/obj/item/reagent_containers/glass/bottle/nutrient/l4z,
/obj/item/reagent_containers/glass/bottle/nutrient/l4z,
/obj/item/reagent_containers/glass/bottle/nutrient/l4z,
/obj/item/reagent_containers/glass/bottle/nutrient/l4z,
/obj/item/reagent_containers/glass/bottle/nutrient/l4z,
/obj/structure/closet/crate,
/turf/open/floor/plating/asteroid/basalt/lava_land_surface,
/area/ruin/powered/mechanicus)
"bV" = (
/obj/structure/water_source/puddle,
/turf/open/floor/plating/asteroid/basalt/lava_land_surface,
/area/ruin/powered/mechanicus)
"bW" = (
/obj/structure/rack,
/obj/item/reagent_containers/glass/bucket/wooden{
	pixel_x = -4;
	pixel_y = -2
	},
/obj/item/reagent_containers/glass/bucket/wooden,
/obj/item/reagent_containers/glass/bucket/wooden{
	pixel_x = 4;
	pixel_y = 2
	},
/turf/open/floor/plating/asteroid/basalt/lava_land_surface,
/area/ruin/powered/mechanicus)
"bX" = (
/obj/effect/turf_decal/tile/purple{
	dir = 8
	},
/obj/effect/turf_decal/tile/purple{
	dir = 1
	},
/obj/effect/turf_decal/tile/purple,
/turf/open/floor/iron/dark,
/area/ruin/powered/mechanicus)
"bY" = (
/obj/structure/closet/secure_closet/mechanicus/augs,
/turf/open/floor/circuit,
/area/ruin/powered/mechanicus)
"bZ" = (
/obj/structure/table/wood/fancy/black,
/obj/item/flashlight/lantern,
/turf/open/floor/iron/grimy,
/area/ruin/powered/mechanicus)
"ca" = (
/obj/machinery/mecha_part_fabricator,
/obj/effect/turf_decal/tile/purple{
	dir = 4
	},
/obj/effect/turf_decal/tile/purple{
	dir = 1
	},
/turf/open/floor/iron/dark,
/area/ruin/powered/mechanicus)
"cb" = (
/obj/structure/rack,
/turf/open/floor/plating/asteroid/basalt/lava_land_surface,
/area/ruin/powered/mechanicus)
"cc" = (
/obj/machinery/mech_bay_recharge_port{
	dir = 1;
	icon_state = "recharge_port"
	},
/obj/effect/turf_decal/tile/purple{
	dir = 4
	},
/obj/effect/turf_decal/tile/purple,
/turf/open/floor/iron/dark,
/area/ruin/powered/mechanicus)
"cd" = (
/obj/structure/table/wood,
/obj/machinery/light/small{
	dir = 4;
	icon_state = "bulb"
	},
/obj/effect/turf_decal/tile/green{
	dir = 1
	},
/obj/effect/turf_decal/tile/green{
	dir = 4
	},
/obj/effect/turf_decal/tile/green,
/turf/open/floor/iron/dark,
/area/ruin/powered/mechanicus)
"ce" = (
/obj/effect/turf_decal/tile/purple{
	dir = 8
	},
/obj/effect/turf_decal/tile/purple,
/turf/open/floor/iron/dark,
/area/ruin/powered/mechanicus)
"dv" = (
/obj/effect/turf_decal/tile/brown{
	dir = 4
	},
/obj/effect/turf_decal/tile/brown{
	dir = 1
	},
/obj/effect/turf_decal/tile/brown,
/obj/structure/closet/crate/maint,
/obj/effect/spawner/lootdrop/maintenance/three,
/turf/open/floor/iron/dark,
/area/ruin/powered/mechanicus)
"dD" = (
/obj/effect/turf_decal/tile/blue{
	dir = 8
	},
/obj/effect/turf_decal/tile/blue,
/obj/effect/turf_decal/tile/blue{
	dir = 4
	},
/turf/open/floor/iron/dark,
/area/ruin/powered/mechanicus)
"fd" = (
/obj/effect/turf_decal/tile/brown,
/turf/open/floor/iron/dark,
/area/ruin/powered/mechanicus)
"fO" = (
/obj/structure/extinguisher_cabinet{
	pixel_y = -32
	},
/turf/open/floor/iron/grimy,
/area/ruin/powered/mechanicus)
"gh" = (
/obj/effect/turf_decal/tile/brown{
	dir = 8
	},
/obj/effect/turf_decal/tile/brown{
	dir = 4
	},
/obj/effect/turf_decal/tile/brown,
/obj/structure/closet/crate/maint,
/obj/effect/spawner/lootdrop/maintenance/three,
/turf/open/floor/iron/dark,
/area/ruin/powered/mechanicus)
"gQ" = (
/obj/effect/turf_decal/tile/brown{
	dir = 4
	},
/obj/effect/turf_decal/tile/brown,
/obj/effect/turf_decal/loading_area,
/turf/open/floor/iron/dark,
/area/ruin/powered/mechanicus)
"iw" = (
/obj/effect/turf_decal/trimline/red/line{
	dir = 10;
	icon_state = "trimline"
	},
/turf/open/floor/iron/dark,
/area/ruin/powered/mechanicus)
"jE" = (
/obj/effect/turf_decal/tile/brown{
	dir = 8
	},
/obj/effect/turf_decal/tile/brown{
	dir = 1
	},
/obj/effect/turf_decal/tile/brown,
/turf/open/floor/iron/dark,
/area/ruin/powered/mechanicus)
"ke" = (
/obj/effect/turf_decal/tile/brown{
	dir = 4
	},
/obj/effect/turf_decal/tile/brown{
	dir = 8
	},
/obj/effect/turf_decal/tile/brown,
/turf/open/floor/iron/dark,
/area/ruin/powered/mechanicus)
"ml" = (
/obj/effect/turf_decal/tile/brown{
	dir = 8
	},
/obj/effect/turf_decal/tile/brown,
/obj/machinery/door/window/northleft,
/obj/structure/reagent_dispensers/fueltank/large,
/turf/open/floor/iron/dark,
/area/ruin/powered/mechanicus)
"nV" = (
/obj/effect/turf_decal/tile/brown{
	dir = 8
	},
/obj/effect/turf_decal/tile/brown{
	dir = 1
	},
/turf/open/floor/iron/dark,
/area/ruin/powered/mechanicus)
"rN" = (
/obj/machinery/door/airlock/mining{
	name = "Backyard";
	req_access = 220
	},
/obj/structure/fans/tiny,
/obj/effect/turf_decal/tile/brown,
/obj/effect/turf_decal/tile/brown{
	dir = 8
	},
/turf/open/floor/iron/dark,
/area/ruin/powered/mechanicus)
"sW" = (
/obj/item/circuitboard/computer/operating,
/obj/item/circuitboard/machine/chem_dispenser,
/obj/item/circuitboard/machine/stasis,
/obj/item/circuitboard/machine/stasis,
/obj/structure/closet/crate/medical,
/obj/effect/turf_decal/tile/brown{
	dir = 1
	},
/obj/effect/turf_decal/tile/brown{
	dir = 4
	},
/turf/open/floor/iron/dark,
/area/ruin/powered/mechanicus)
"uz" = (
/obj/structure/bed/pod,
/obj/effect/mob_spawn/human/techcult{
	dir = 8;
	icon_state = "sleeper"
	},
/obj/effect/turf_decal/tile/green{
	dir = 8
	},
/obj/effect/turf_decal/tile/green{
	dir = 4
	},
/obj/effect/turf_decal/tile/green,
/turf/open/floor/iron/dark,
/area/ruin/powered/mechanicus)
"vg" = (
/obj/effect/turf_decal/tile/brown{
	dir = 4
	},
/obj/effect/turf_decal/tile/brown{
	dir = 1
	},
/obj/structure/closet/crate/maint,
/turf/open/floor/iron/dark,
/area/ruin/powered/mechanicus)
"vr" = (
/obj/machinery/door/airlock/mining/glass{
	name = "Storage Room";
	req_access = 220
	},
/obj/effect/turf_decal/tile/brown,
/obj/effect/turf_decal/tile/brown{
	dir = 1
	},
/obj/effect/turf_decal/tile/brown{
	dir = 8
	},
/obj/effect/turf_decal/tile/brown{
	dir = 4
	},
/turf/open/floor/iron/dark,
/area/ruin/powered/mechanicus)
"xD" = (
/obj/effect/turf_decal/tile/brown{
	dir = 1
	},
/obj/effect/turf_decal/tile/brown{
	dir = 4
	},
/turf/open/floor/iron/dark,
/area/ruin/powered/mechanicus)
"Af" = (
/obj/effect/turf_decal/tile/blue,
/obj/effect/turf_decal/tile/blue{
	dir = 4
	},
/turf/open/floor/iron/dark,
/area/ruin/powered/mechanicus)
"Cm" = (
/obj/effect/turf_decal/tile/brown{
	dir = 8
	},
/obj/effect/turf_decal/tile/brown,
/obj/machinery/portable_atmospherics/canister/oxygen,
/turf/open/floor/iron/dark,
/area/ruin/powered/mechanicus)
"Ec" = (
/obj/machinery/door/airlock/grunge{
	name = "Chapel";
	req_access = 220
	},
/turf/open/floor/iron/dark,
/area/ruin/powered/mechanicus)
"GT" = (
/obj/structure/closet/crate/maint,
/turf/open/floor/iron/dark,
/area/ruin/powered/mechanicus)
"Hf" = (
/obj/effect/turf_decal/tile/brown{
	dir = 8
	},
/obj/effect/turf_decal/tile/brown,
/obj/machinery/portable_atmospherics/canister/air,
/turf/open/floor/iron/dark,
/area/ruin/powered/mechanicus)
"If" = (
/obj/effect/turf_decal/tile/brown{
	dir = 4
	},
/obj/effect/turf_decal/tile/brown,
/obj/structure/closet/crate/maint,
/turf/open/floor/iron/dark,
/area/ruin/powered/mechanicus)
"IW" = (
/obj/machinery/door/airlock/grunge{
	req_access = 220
	},
/obj/structure/fans/tiny,
/turf/open/floor/iron/dark,
/area/ruin/powered/mechanicus)
"MA" = (
/obj/structure/table,
/obj/item/storage/bag/ore,
/obj/item/storage/bag/ore,
/obj/item/storage/bag/ore,
/obj/item/storage/bag/ore,
/obj/item/storage/bag/ore,
/obj/effect/turf_decal/trimline/red/line{
	dir = 1;
	icon_state = "trimline"
	},
/turf/open/floor/iron/dark,
/area/ruin/powered/mechanicus)
"MD" = (
/obj/effect/turf_decal/tile/brown{
	dir = 8
	},
/obj/effect/turf_decal/tile/brown,
/obj/structure/window/reinforced{
	dir = 4
	},
/obj/structure/tank_dispenser/oxygen,
/turf/open/floor/iron/dark,
/area/ruin/powered/mechanicus)
"MR" = (
/obj/machinery/door/airlock/research/glass{
	name = "Surgery";
	req_access = 220
	},
/turf/open/floor/iron/dark,
/area/ruin/powered/mechanicus)
"Nq" = (
/obj/effect/turf_decal/tile/brown{
	dir = 4
	},
/obj/structure/closet/crate/maint,
/obj/effect/spawner/lootdrop/maintenance/three,
/obj/effect/turf_decal/tile/brown{
	dir = 1
	},
/turf/open/floor/iron/dark,
/area/ruin/powered/mechanicus)
"OJ" = (
/obj/effect/turf_decal/tile/brown{
	dir = 1
	},
/obj/effect/turf_decal/tile/brown{
	dir = 8
	},
/turf/open/floor/iron/dark,
/area/ruin/powered/mechanicus)
"Qx" = (
/obj/effect/turf_decal/tile/brown{
	dir = 8
	},
/obj/effect/turf_decal/tile/brown,
/obj/effect/turf_decal/tile/brown{
	dir = 4
	},
/turf/open/floor/iron/dark,
/area/ruin/powered/mechanicus)
"Sj" = (
/obj/machinery/door/airlock/research/glass{
	name = "Robotics Lab";
	req_access = 220
	},
/turf/open/floor/iron/dark,
/area/ruin/powered/mechanicus)
"TE" = (
/obj/structure/closet/crate/science{
	name = "nanites crate"
	},
/obj/item/circuitboard/computer/nanite_cloud_controller,
/obj/item/circuitboard/machine/nanite_program_hub,
/obj/item/circuitboard/machine/nanite_programmer,
/obj/item/circuitboard/machine/public_nanite_chamber,
/obj/item/disk/nanite_program/repairing,
/obj/item/disk/nanite_program,
/obj/item/nanite_scanner,
/obj/item/nanite_remote,
/obj/effect/turf_decal/tile/brown{
	dir = 1
	},
/obj/effect/turf_decal/tile/brown{
	dir = 4
	},
/obj/effect/turf_decal/tile/brown{
	dir = 8
	},
/turf/open/floor/iron/dark,
/area/ruin/powered/mechanicus)
"TV" = (
/obj/structure/table,
/obj/effect/turf_decal/trimline/red/line{
	dir = 5;
	icon_state = "trimline"
	},
/obj/item/clothing/mask/gas/cyborg,
/obj/item/clothing/mask/gas/cyborg,
/obj/item/clothing/mask/gas/cyborg,
/obj/item/clothing/mask/gas/cyborg,
/obj/item/clothing/mask/gas/cyborg,
/turf/open/floor/iron/dark,
/area/ruin/powered/mechanicus)
"Vq" = (
/obj/effect/turf_decal/tile/brown{
	dir = 4
	},
/obj/effect/turf_decal/tile/brown{
	dir = 1
	},
/turf/open/floor/iron/dark,
/area/ruin/powered/mechanicus)
"VK" = (
/obj/structure/closet/crate/maint,
/obj/effect/spawner/lootdrop/maintenance/three,
/turf/open/floor/iron/dark,
/area/ruin/powered/mechanicus)
"WO" = (
/obj/effect/turf_decal/tile/brown{
	dir = 8
	},
/obj/effect/turf_decal/tile/brown,
/obj/effect/turf_decal/tile/brown{
	dir = 4
	},
/obj/machinery/door/window/northright,
/obj/structure/reagent_dispensers/watertank/high,
/turf/open/floor/iron/dark,
/area/ruin/powered/mechanicus)
"WS" = (
/obj/effect/turf_decal/tile/brown{
	dir = 1
	},
/obj/effect/turf_decal/tile/brown{
	dir = 4
	},
/obj/effect/turf_decal/tile/brown,
/obj/machinery/mineral/ore_redemption{
	input_dir = 8;
	req_access = 220
	},
/turf/open/floor/iron/dark,
/area/ruin/powered/mechanicus)
"Xo" = (
/obj/machinery/light,
/obj/effect/turf_decal/tile/brown{
	dir = 8
	},
/obj/effect/turf_decal/tile/brown,
/turf/open/floor/iron/dark,
/area/ruin/powered/mechanicus)

(1,1,1) = {"
aa
aa
aa
aa
aa
be
be
be
be
be
be
be
be
be
be
be
aa
aa
aa
aa
aa
aa
aa
aa
aa
aa
"}
(2,1,1) = {"
aa
aa
aa
be
be
be
be
be
be
be
be
be
be
be
be
be
be
be
aa
aa
aa
aa
aa
aa
aa
aa
"}
(3,1,1) = {"
aa
aa
aa
be
aV
aV
aV
aV
aV
aV
aV
aV
aV
aV
aV
aV
aV
be
aa
aa
aa
aa
aa
aa
aa
aa
"}
(4,1,1) = {"
aa
aa
aa
be
aV
at
aH
aH
aA
bI
bX
aV
bT
bq
bC
bF
aV
be
aa
aa
aa
aa
aa
aa
aa
aa
"}
(5,1,1) = {"
aa
aa
aa
be
aV
ai
bD
bD
aB
bD
ce
aV
bY
bp
aT
bG
aV
be
aa
aa
aa
aa
aa
aa
aa
aa
"}
(6,1,1) = {"
aa
aa
be
be
aV
ca
aI
aI
aX
bD
bI
aV
bo
bp
bD
bH
aV
be
aa
aa
aa
aa
aa
aa
aa
aa
"}
(7,1,1) = {"
aa
aa
be
be
aV
al
bD
bD
bD
bD
bD
Sj
bq
bA
bE
bn
aV
be
aa
aa
aa
aa
aa
aa
aa
aa
"}
(8,1,1) = {"
aa
be
be
be
aV
av
aJ
bD
bc
bL
cc
aV
aU
Af
dD
bF
aV
be
aa
aa
aa
aa
aa
aa
aa
aa
"}
(9,1,1) = {"
aa
be
be
ab
aV
aV
aV
Sj
aV
aV
aV
aV
MR
aV
aV
aV
aV
be
aa
aa
aa
aa
aa
aa
aa
aa
"}
(10,1,1) = {"
be
be
ab
ab
am
aO
ac
ac
ac
ac
aO
ac
ac
aV
bg
iw
bS
be
be
aa
aa
aa
aa
aa
aa
aa
"}
(11,1,1) = {"
be
ab
ab
ac
ac
ac
ac
bM
bM
bM
bM
ac
ac
aV
bh
bQ
bS
be
be
aa
aa
aa
aa
aa
aa
aa
"}
(12,1,1) = {"
be
ab
ac
ac
an
bZ
ac
bM
bM
bM
bM
ac
ac
aV
MA
bQ
bS
be
be
be
aa
aa
aa
aa
aa
aa
"}
(13,1,1) = {"
be
ab
ac
ac
ac
ao
ac
ac
bM
bM
bM
ac
fO
aV
bj
bQ
aV
bd
bf
bf
bf
bf
bf
bf
bf
aa
"}
(14,1,1) = {"
be
ab
ac
af
ac
ag
ac
ac
ac
ac
ac
ac
ac
Ec
bj
bQ
IW
aS
bf
bf
bf
bf
bf
bf
bf
aa
"}
(15,1,1) = {"
be
ab
ac
ac
ac
an
ac
ac
bM
bM
bM
ac
ac
aV
bk
bQ
aV
bd
bf
bf
bf
bf
bf
bf
bf
aa
"}
(16,1,1) = {"
be
ab
ac
ac
an
bZ
ac
bM
bM
bM
bM
ac
ac
aV
bl
bQ
bS
be
be
aa
aa
aa
aa
aa
aa
aa
"}
(17,1,1) = {"
be
ab
ab
ac
ac
ac
ac
bM
bM
bM
bM
ac
ac
aV
bK
bQ
bS
be
be
aa
aa
aa
aa
aa
aa
aa
"}
(18,1,1) = {"
be
be
ab
ab
ac
aw
ac
ac
ac
ac
aw
ac
ac
aV
TV
br
bS
be
aa
aa
aa
aa
aa
aa
aa
aa
"}
(19,1,1) = {"
aa
be
be
ab
aV
aV
aV
aV
bv
aV
aV
aV
aV
aV
aV
bu
aV
be
aa
aa
aa
aa
aa
aa
aa
aa
"}
(20,1,1) = {"
aa
be
be
be
aV
au
bJ
aW
bD
aW
bN
bP
aV
aY
OJ
bw
aV
be
aa
aa
aa
aa
aa
aa
aa
aa
"}
(21,1,1) = {"
aa
aa
be
be
aV
ay
aL
aV
bD
aV
cd
uz
aV
aZ
bD
by
aV
be
aa
aa
aa
aa
aa
aa
aa
aa
"}
(22,1,1) = {"
aa
aa
be
be
aV
aV
aV
aV
bz
aV
aV
aV
aV
ba
bD
Xo
aV
be
aa
aa
aa
aa
aa
aa
aa
aa
"}
(23,1,1) = {"
aa
aa
be
be
aV
au
bJ
aW
bD
aW
bN
bP
aV
bb
bD
by
aV
be
aa
aa
aa
aa
aa
aa
aa
aa
"}
(24,1,1) = {"
aa
aa
be
be
aV
ay
aL
aV
bD
aV
cd
uz
aV
WS
gQ
ke
aV
be
aa
aa
aa
aa
aa
aa
aa
aa
"}
(25,1,1) = {"
aa
aa
be
be
aV
aV
aV
aV
bB
aV
aV
aV
aV
aV
aV
vr
aV
be
aa
aa
aa
aa
aa
aa
aa
aa
"}
(26,1,1) = {"
aa
aa
be
be
ar
az
az
az
aC
bO
bS
TE
nV
nV
nV
jE
aV
be
aa
aa
aa
aa
aa
aa
aa
aa
"}
(27,1,1) = {"
aa
aa
be
be
ar
aC
aC
aC
aC
bR
bS
sW
bD
bD
bD
by
aV
be
aa
aa
aa
aa
aa
aa
aa
aa
"}
(28,1,1) = {"
aa
aa
be
be
ar
az
az
az
aC
bU
bS
xD
bD
bD
bD
by
aV
be
aa
aa
aa
aa
aa
aa
aa
aa
"}
(29,1,1) = {"
aa
aa
aa
be
ar
aC
aC
aC
aC
aC
aV
xD
bD
bD
bD
Hf
aV
be
aa
aa
aa
aa
aa
aa
aa
aa
"}
(30,1,1) = {"
aa
aa
aa
be
ar
az
az
az
aC
aC
rN
xD
bD
bD
bD
Cm
aV
be
aa
aa
aa
aa
aa
aa
aa
aa
"}
(31,1,1) = {"
aa
aa
aa
be
ar
aC
aC
aC
aC
aC
aV
Nq
GT
VK
bD
MD
aV
be
aa
aa
aa
aa
aa
aa
aa
aa
"}
(32,1,1) = {"
aa
aa
aa
be
ar
az
az
az
aC
bV
bS
Vq
bD
bD
bD
ml
aV
be
aa
aa
aa
aa
aa
aa
aa
aa
"}
(33,1,1) = {"
aa
aa
aa
be
ar
aC
aC
aC
aC
bW
bS
vg
VK
bD
fd
WO
aV
be
aa
aa
aa
aa
aa
aa
aa
aa
"}
(34,1,1) = {"
aa
aa
aa
be
ar
az
az
az
aC
cb
bS
Vq
bD
fd
Qx
aV
aV
be
aa
aa
aa
aa
aa
aa
aa
aa
"}
(35,1,1) = {"
aa
aa
aa
be
ar
aC
aC
aC
aC
cb
bS
dv
If
gh
aV
aV
be
be
aa
aa
aa
aa
aa
aa
aa
aa
"}
(36,1,1) = {"
aa
aa
aa
be
as
aD
aD
aD
aD
aD
aV
aV
aV
aV
aV
be
be
aa
aa
aa
aa
aa
aa
aa
aa
aa
"}
(37,1,1) = {"
aa
aa
aa
be
be
be
be
be
be
be
be
be
be
be
be
be
aa
aa
aa
aa
aa
aa
aa
aa
aa
aa
"}
(38,1,1) = {"
aa
aa
aa
aa
aa
be
be
be
be
be
be
be
be
be
aa
aa
aa
aa
aa
aa
aa
aa
aa
aa
aa
aa
"}
