//MAP CONVERTED BY dmm2tgm.py THIS HEADER COMMENT PREVENTS RECONVERSION, DO NOT REMOVE
"a" = (
/obj/machinery/light/directional/west,
/obj/effect/turf_decal/trimline/green/filled/line{
	dir = 8
	},
/obj/machinery/hydroponics/constructable,
/obj/effect/turf_decal/bot,
/turf/open/floor/iron,
/area/shuttle/prison_shuttle)
"b" = (
/turf/closed/wall/mineral/titanium,
/area/shuttle/prison_shuttle)
"c" = (
/obj/effect/turf_decal/trimline/green/filled/line{
	dir = 8
	},
/obj/structure/table/glass,
/obj/machinery/reagentgrinder{
	pixel_y = 4
	},
/turf/open/floor/iron,
/area/shuttle/prison_shuttle)
"d" = (
/obj/effect/turf_decal/tile/green{
	dir = 8
	},
/obj/effect/turf_decal/tile/blue{
	dir = 1
	},
/turf/open/floor/iron,
/area/shuttle/prison_shuttle)
"e" = (
/obj/effect/turf_decal/tile/green{
	dir = 4
	},
/obj/effect/turf_decal/tile/blue{
	dir = 1
	},
/obj/effect/turf_decal/tile/green{
	dir = 8
	},
/turf/open/floor/iron,
/area/shuttle/prison_shuttle)
"f" = (
/turf/open/floor/iron,
/area/shuttle/prison_shuttle)
"g" = (
/obj/machinery/door/airlock/titanium{
	name = "Prison Ship Airlock"
	},
/obj/effect/turf_decal/trimline/green/filled/line{
	dir = 1
	},
/obj/effect/turf_decal/trimline/green/filled/line,
/turf/open/floor/iron,
/area/shuttle/prison_shuttle)
"h" = (
/obj/machinery/light/directional/east,
/obj/effect/turf_decal/trimline/green/filled/line{
	dir = 5
	},
/obj/structure/table/glass,
/obj/item/clothing/suit/apron,
/turf/open/floor/iron,
/area/shuttle/prison_shuttle)
"i" = (
/obj/docking_port/mobile/prison,
/obj/machinery/door/airlock/titanium{
	name = "Prison Ship Airlock"
	},
/obj/effect/turf_decal/trimline/green/filled/line{
	dir = 1
	},
/obj/effect/turf_decal/trimline/green/filled/line,
/turf/open/floor/iron,
/area/shuttle/prison_shuttle)
"k" = (
/obj/machinery/smartfridge/prison/hydroponics,
/turf/closed/wall/mineral/titanium,
/area/shuttle/prison_shuttle)
"l" = (
/obj/effect/turf_decal/tile/green{
	dir = 4
	},
/obj/effect/turf_decal/tile/blue,
/obj/effect/turf_decal/tile/green{
	dir = 8
	},
/turf/open/floor/iron,
/area/shuttle/prison_shuttle)
"m" = (
/obj/machinery/light/directional/east,
/obj/effect/turf_decal/trimline/green/filled/line{
	dir = 4
	},
/turf/open/floor/iron,
/area/shuttle/prison_shuttle)
"n" = (
/obj/effect/turf_decal/trimline/green/filled/line{
	dir = 4
	},
/obj/item/radio/intercom/prison/directional/east,
/turf/open/floor/iron,
/area/shuttle/prison_shuttle)
"o" = (
/obj/effect/turf_decal/tile/blue,
/obj/effect/turf_decal/tile/green{
	dir = 8
	},
/turf/open/floor/iron,
/area/shuttle/prison_shuttle)
"q" = (
/obj/structure/window/reinforced{
	dir = 1
	},
/obj/structure/shuttle/engine/heater,
/turf/open/floor/plating/airless,
/area/shuttle/prison_shuttle)
"s" = (
/turf/template_noop,
/area/template_noop)
"t" = (
/obj/structure/shuttle/engine/propulsion/burst/left,
/turf/open/floor/plating/airless,
/area/shuttle/prison_shuttle)
"u" = (
/obj/structure/shuttle/engine/propulsion,
/turf/open/floor/plating/airless,
/area/shuttle/prison_shuttle)
"v" = (
/obj/structure/shuttle/engine/propulsion/burst/right,
/turf/open/floor/plating/airless,
/area/shuttle/prison_shuttle)
"z" = (
/obj/effect/turf_decal/trimline/green/filled/line{
	dir = 10
	},
/obj/machinery/hydroponics/constructable,
/obj/effect/turf_decal/bot,
/turf/open/floor/iron,
/area/shuttle/prison_shuttle)
"A" = (
/obj/effect/turf_decal/trimline/green/filled/line,
/turf/open/floor/iron,
/area/shuttle/prison_shuttle)
"B" = (
/obj/effect/turf_decal/trimline/green/filled/line{
	dir = 4
	},
/obj/structure/table/glass,
/obj/item/reagent_containers/glass/bucket,
/turf/open/floor/iron,
/area/shuttle/prison_shuttle)
"C" = (
/obj/machinery/light/directional/east,
/obj/effect/turf_decal/trimline/green/filled/line{
	dir = 6
	},
/obj/machinery/vending/hydronutrients,
/turf/open/floor/iron,
/area/shuttle/prison_shuttle)
"D" = (
/obj/effect/turf_decal/trimline/green/filled/line{
	dir = 1
	},
/obj/structure/sink{
	pixel_y = 22
	},
/turf/open/floor/iron,
/area/shuttle/prison_shuttle)
"F" = (
/obj/effect/turf_decal/tile/green{
	dir = 4
	},
/obj/effect/turf_decal/tile/blue,
/turf/open/floor/iron,
/area/shuttle/prison_shuttle)
"G" = (
/obj/effect/turf_decal/trimline/green/filled/line{
	dir = 8
	},
/obj/machinery/hydroponics/constructable,
/obj/effect/turf_decal/bot,
/turf/open/floor/iron,
/area/shuttle/prison_shuttle)
"J" = (
/obj/effect/turf_decal/trimline/green/filled/line{
	dir = 4
	},
/obj/structure/table/glass,
/obj/item/book/manual/hydroponics_pod_people,
/turf/open/floor/iron,
/area/shuttle/prison_shuttle)
"O" = (
/obj/effect/turf_decal/trimline/green/filled/corner,
/obj/effect/turf_decal/trimline/green/filled/corner{
	dir = 4
	},
/turf/open/floor/iron,
/area/shuttle/prison_shuttle)
"P" = (
/obj/effect/turf_decal/tile/blue,
/obj/effect/turf_decal/tile/green{
	dir = 8
	},
/obj/effect/turf_decal/tile/blue{
	dir = 1
	},
/turf/open/floor/iron,
/area/shuttle/prison_shuttle)
"Q" = (
/obj/effect/turf_decal/trimline/green/filled/line{
	dir = 8
	},
/obj/machinery/biogenerator,
/turf/open/floor/iron,
/area/shuttle/prison_shuttle)
"R" = (
/obj/effect/turf_decal/tile/green{
	dir = 4
	},
/obj/effect/turf_decal/tile/blue{
	dir = 1
	},
/turf/open/floor/iron,
/area/shuttle/prison_shuttle)
"S" = (
/obj/effect/turf_decal/trimline/green/filled/line{
	dir = 4
	},
/obj/machinery/vending/hydroseeds,
/turf/open/floor/iron,
/area/shuttle/prison_shuttle)
"V" = (
/obj/effect/turf_decal/trimline/green/filled/line{
	dir = 9
	},
/obj/machinery/chem_master/condimaster{
	desc = "Used to separate out liquids - useful for purifying botanical extracts. Also dispenses condiments.";
	name = "SapMaster XP"
	},
/turf/open/floor/iron,
/area/shuttle/prison_shuttle)
"W" = (
/obj/machinery/light/directional/west,
/obj/effect/turf_decal/trimline/green/filled/line{
	dir = 8
	},
/obj/machinery/seed_extractor,
/turf/open/floor/iron,
/area/shuttle/prison_shuttle)
"X" = (
/obj/effect/turf_decal/tile/green{
	dir = 4
	},
/obj/effect/turf_decal/tile/blue{
	dir = 1
	},
/obj/effect/turf_decal/tile/blue,
/turf/open/floor/iron,
/area/shuttle/prison_shuttle)

(1,1,1) = {"
b
b
b
b
b
b
b
b
b
b
b
s
"}
(2,1,1) = {"
b
V
c
W
Q
G
G
a
G
z
b
t
"}
(3,1,1) = {"
b
D
e
d
d
d
d
d
P
A
q
u
"}
(4,1,1) = {"
b
D
R
f
f
f
f
f
o
A
q
u
"}
(5,1,1) = {"
b
D
X
F
F
F
F
F
l
A
q
u
"}
(6,1,1) = {"
b
h
B
J
O
m
O
n
S
C
b
v
"}
(7,1,1) = {"
b
b
b
b
g
k
i
b
b
b
b
s
"}
