"af" = (/obj/effect/mob_spawn/human/beefman/cytology,/turf/open/floor/plasteel/white,/area/ruin/powered/beefcyto)
"al" = (/obj/structure/marker_beacon,/turf/open/floor/plating/asteroid/snow/atmosphere,/area/icemoon/underground/explored)
"aX" = (/obj/machinery/light{dir = 4},/turf/open/floor/mineral/plastitanium/red,/area/ruin/powered/beefcyto)
"bl" = (/obj/structure/window/reinforced/spawner,/obj/structure/window/reinforced/spawner{dir = 4},/turf/open/floor/grass,/area/ruin/powered/beefcyto)
"bx" = (/obj/structure/table/reinforced,/obj/item/wrench,/obj/item/storage/box/beakers/bluespace,/turf/open/floor/plasteel/white,/area/ruin/powered/beefcyto)
"bI" = (/turf/closed/wall/r_wall,/area/ruin/powered/beefcyto)
"bZ" = (/obj/machinery/light,/turf/open/floor/plasteel/white,/area/ruin/powered/beefcyto)
"cx" = (/obj/machinery/jukebox,/turf/open/floor/eighties,/area/ruin/powered/beefcyto)
"cY" = (/obj/machinery/door/airlock/public,/turf/open/floor/plating,/area/ruin/powered/beefcyto)
"dr" = (/obj/structure/table/glass,/turf/open/floor/plasteel/white,/area/ruin/powered/beefcyto)
"dI" = (/obj/item/book/manual/wiki/cytology,/obj/machinery/smartfridge/petri/preloaded,/turf/open/floor/plasteel/white,/area/ruin/powered/beefcyto)
"dW" = (/obj/structure/fence/corner{dir = 1},/turf/open/floor/plating/asteroid/snow/icemoon,/area/icemoon/underground/explored)
"ee" = (/obj/structure/fence{dir = 4},/obj/structure/fence/post,/turf/open/floor/plating/asteroid/snow/icemoon,/area/icemoon/underground/explored)
"ef" = (/obj/machinery/door/window{dir = 4},/turf/open/floor/grass,/area/ruin/powered/beefcyto)
"eh" = (/obj/structure/moisture_trap,/turf/open/floor/plasteel/kitchen_coldroom,/area/ruin/powered/beefcyto)
"el" = (/obj/structure/chair/sofa/corp{dir = 1},/turf/open/floor/eighties,/area/ruin/powered/beefcyto)
"et" = (/obj/effect/spawner/structure/window/reinforced,/turf/open/floor/plating,/area/ruin/powered/beefcyto)
"ey" = (/obj/structure/kitchenspike,/turf/open/floor/plasteel/kitchen_coldroom,/area/ruin/powered/beefcyto)
"fu" = (/turf/open/floor/plasteel/white,/area/ruin/powered/beefcyto)
"fB" = (/obj/effect/turf_decal/trimline/blue/filled/line,/obj/machinery/chem_master,/turf/open/floor/plasteel/white,/area/ruin/powered/beefcyto)
"fU" = (/obj/machinery/door/airlock/public/glass,/turf/open/floor/plating,/area/ruin/powered/beefcyto)
"fY" = (/obj/structure/marker_beacon,/obj/structure/flora/ash/chilly,/turf/open/floor/plating/asteroid/snow/icemoon,/area/icemoon/underground/explored)
"ga" = (/obj/machinery/chem_master/condimaster,/turf/open/floor/plasteel/kitchen_coldroom,/area/ruin/powered/beefcyto)
"gN" = (/obj/structure/fans/tiny/invisible,/turf/open/floor/plating/asteroid/snow/atmosphere,/area/icemoon/underground/explored)
"hn" = (/obj/effect/decal/cleanable/garbage,/turf/open/floor/plating/asteroid/snow/atmosphere,/area/icemoon/underground/explored)
"hL" = (/turf/open/floor/grass,/area/ruin/powered/beefcyto)
"hU" = (/obj/effect/turf_decal/trimline/blue/filled/line,/obj/machinery/chem_dispenser,/turf/open/floor/plasteel/white,/area/ruin/powered/beefcyto)
"hX" = (/obj/machinery/vending/boozeomat/all_access,/turf/open/floor/plasteel/cafeteria,/area/ruin/powered/beefcyto)
"ie" = (/turf/open/floor/mineral/plastitanium/red,/area/ruin/powered/beefcyto)
"if" = (/obj/structure/window,/turf/open/floor/plasteel/kitchen_coldroom,/area/ruin/powered/beefcyto)
"ii" = (/turf/open/floor/plating/asteroid/snow/atmosphere,/area/icemoon/underground/explored)
"io" = (/obj/machinery/button/door{id = "blobbernaut door"; name = "blobbernaut door bolt"; normaldoorcontrol = 1; specialfunctions = 4},/turf/closed/wall/r_wall,/area/ruin/powered/beefcyto)
"iA" = (/obj/structure/marker_beacon,/obj/structure/flora/grass/both,/turf/open/floor/plating/asteroid/snow/icemoon,/area/icemoon/underground/explored)
"iT" = (/obj/effect/turf_decal/trimline/blue/filled/line{dir = 8},/turf/open/floor/plasteel/white,/area/ruin/powered/beefcyto)
"jn" = (/obj/machinery/light{dir = 4},/turf/open/floor/plasteel/white,/area/ruin/powered/beefcyto)
"jR" = (/obj/effect/turf_decal/trimline/purple/filled/line{dir = 4},/turf/open/floor/plasteel/white,/area/ruin/powered/beefcyto)
"kK" = (/obj/effect/decal/cleanable/blood/old,/turf/open/floor/plating/snowed,/area/icemoon/underground/explored)
"lv" = (/obj/machinery/light{dir = 8},/turf/open/floor/plasteel/white,/area/ruin/powered/beefcyto)
"lQ" = (/obj/machinery/seed_extractor,/turf/open/floor/plasteel/white,/area/ruin/powered/beefcyto)
"mn" = (/obj/machinery/griddle,/turf/open/floor/plasteel/cafeteria,/area/ruin/powered/beefcyto)
"mD" = (/obj/effect/turf_decal/trimline/green/filled/line{dir = 8},/turf/open/floor/plasteel/white,/area/ruin/powered/beefcyto)
"mY" = (/obj/structure/fence/corner{dir = 8},/turf/open/floor/plating/asteroid/snow/icemoon,/area/icemoon/underground/explored)
"nd" = (/obj/effect/turf_decal/tile/blue{dir = 8},/obj/effect/turf_decal/tile/blue,/obj/effect/turf_decal/tile/blue{dir = 4},/obj/effect/turf_decal/tile/blue{dir = 1},/turf/open/floor/plasteel/white,/area/ruin/powered/beefcyto)
"ng" = (/obj/machinery/plumbing/growing_vat,/turf/open/floor/plasteel/white,/area/ruin/powered/beefcyto)
"nh" = (/obj/machinery/plumbing/input,/turf/open/floor/plasteel/white,/area/ruin/powered/beefcyto)
"nH" = (/obj/effect/turf_decal/trimline/blue/filled/line,/obj/structure/window/reinforced/spawner{dir = 4},/turf/open/floor/plasteel/white,/area/ruin/powered/beefcyto)
"nP" = (/obj/structure/fence{dir = 4},/turf/open/floor/plating/asteroid/snow/icemoon,/area/icemoon/underground/explored)
"os" = (/obj/effect/turf_decal/trimline/purple/filled/line,/obj/machinery/light,/turf/open/floor/plasteel/white,/area/ruin/powered/beefcyto)
"oY" = (/obj/structure/closet/crate/wooden,/obj/item/stack/sheet/mineral/wood{amount = 10},/turf/open/floor/plating/asteroid/snow/icemoon,/area/icemoon/underground/explored)
"pr" = (/mob/living/simple_animal/mouse/white,/turf/open/floor/plating,/area/ruin/powered/beefcyto)
"pG" = (/mob/living/simple_animal/hostile/retaliate/goat,/obj/effect/turf_decal/siding/blue/end{dir = 8},/turf/open/floor/plasteel/kitchen_coldroom,/area/ruin/powered/beefcyto)
"pT" = (/obj/structure/grille,/turf/open/floor/plating,/area/ruin/powered/beefcyto)
"qf" = (/obj/structure/marker_beacon,/turf/open/floor/plating/asteroid/snow/icemoon,/area/icemoon/underground/explored)
"qp" = (/obj/structure/table/reinforced,/turf/open/floor/plasteel/cafeteria,/area/ruin/powered/beefcyto)
"rg" = (/obj/machinery/microwave,/obj/structure/table/reinforced,/turf/open/floor/plasteel/cafeteria,/area/ruin/powered/beefcyto)
"rj" = (/obj/effect/turf_decal/trimline/green/filled/line{dir = 1},/turf/open/floor/plasteel/white,/area/ruin/powered/beefcyto)
"rY" = (/obj/structure/marker_beacon,/obj/structure/fence,/turf/open/floor/plating/asteroid/snow/icemoon,/area/icemoon/underground/explored)
"sc" = (/obj/structure/flora/tree/pine,/turf/open/floor/plating/asteroid/snow/icemoon,/area/icemoon/underground/explored)
"sy" = (/obj/structure/closet/secure_closet/cytology{req_access = null},/obj/effect/turf_decal/trimline/green/filled/line{dir = 4},/obj/item/clothing/suit/toggle/labcoat/science,/turf/open/floor/plasteel/white,/area/ruin/powered/beefcyto)
"sz" = (/obj/structure/fence/door{dir = 4},/turf/open/floor/plating/asteroid/snow/icemoon,/area/icemoon/underground/explored)
"tb" = (/obj/effect/turf_decal/tile/blue{dir = 8},/obj/effect/turf_decal/tile/blue,/obj/effect/turf_decal/tile/blue{dir = 4},/obj/effect/turf_decal/tile/blue{dir = 1},/obj/machinery/light{dir = 4},/turf/open/floor/plasteel/white,/area/ruin/powered/beefcyto)
"ts" = (/obj/machinery/light,/turf/open/floor/plasteel/kitchen_coldroom,/area/ruin/powered/beefcyto)
"tt" = (/obj/effect/turf_decal/trimline/purple/filled/line,/turf/open/floor/plasteel/white,/area/ruin/powered/beefcyto)
"tA" = (/obj/structure/fireplace,/turf/open/floor/plasteel/white,/area/ruin/powered/beefcyto)
"tF" = (/mob/living/simple_animal/pet/penguin/emperor,/turf/open/floor/plating/asteroid/snow/atmosphere,/area/icemoon/underground/explored)
"tN" = (/obj/effect/turf_decal/caution{dir = 1},/obj/machinery/light/floor,/turf/open/floor/plating,/area/ruin/powered/beefcyto)
"tW" = (/obj/machinery/light,/obj/effect/turf_decal/trimline/blue/filled/line{dir = 10},/turf/open/floor/plasteel/white,/area/ruin/powered/beefcyto)
"ug" = (/turf/open/floor/plating/asteroid/snow/icemoon,/area/icemoon/underground/explored)
"uq" = (/obj/effect/turf_decal/trimline/purple/filled/line{dir = 8},/obj/machinery/light{dir = 8},/turf/open/floor/plasteel/white,/area/ruin/powered/beefcyto)
"ux" = (/obj/structure/closet/crate/bin,/obj/item/clothing/shoes/clown_shoes,/obj/item/food/breadslice/moldy,/obj/item/food/pizzaslice/moldy,/turf/open/floor/plasteel/white,/area/ruin/powered/beefcyto)
"uV" = (/obj/machinery/door/airlock/public/glass,/turf/open/floor/plating/snowed,/area/ruin/powered/beefcyto)
"va" = (/obj/machinery/chem_dispenser/drinks/beer/fullupgrade,/obj/structure/table/wood,/turf/open/floor/plasteel/white,/area/ruin/powered/beefcyto)
"vX" = (/obj/structure/moisture_trap,/turf/open/floor/plating,/area/ruin/powered/beefcyto)
"wj" = (/obj/structure/flora/rock/pile/icy,/turf/open/floor/plating/asteroid/snow/icemoon,/area/icemoon/underground/explored)
"ww" = (/obj/structure/grille,/obj/structure/window/reinforced/fulltile/ice,/turf/open/space/basic,/area/ruin/powered/beefcyto)
"xf" = (/obj/effect/turf_decal/trimline/green/filled/line{dir = 5},/turf/open/floor/plasteel/white,/area/ruin/powered/beefcyto)
"xg" = (/obj/structure/window/reinforced/spawner{dir = 4},/turf/open/floor/grass,/area/ruin/powered/beefcyto)
"xl" = (/obj/machinery/light/floor,/turf/open/floor/plating,/area/ruin/powered/beefcyto)
"xo" = (/obj/machinery/hydroponics/constructable,/obj/effect/turf_decal/trimline/green,/turf/open/floor/plasteel/white,/area/ruin/powered/beefcyto)
"xD" = (/obj/structure/fence/corner,/turf/open/floor/plating/asteroid/snow/icemoon,/area/icemoon/underground/explored)
"xF" = (/turf/open/floor/plating,/area/ruin/powered/beefcyto)
"yi" = (/obj/effect/turf_decal/tile/red,/obj/effect/turf_decal/tile/red{dir = 8},/obj/effect/turf_decal/tile/red{dir = 1},/obj/effect/turf_decal/tile/red{dir = 4},/turf/open/floor/plasteel/white,/area/ruin/powered/beefcyto)
"yD" = (/obj/machinery/door/airlock/survival_pod,/turf/open/floor/mineral/plastitanium/red,/area/ruin/powered/beefcyto)
"yE" = (/obj/structure/closet/l3closet/virology,/obj/effect/turf_decal/trimline/blue/filled/line{dir = 4},/turf/open/floor/plasteel/white,/area/ruin/powered/beefcyto)
"yV" = (/obj/effect/turf_decal/trimline/purple/filled/line{dir = 8},/turf/open/floor/plasteel/white,/area/ruin/powered/beefcyto)
"yX" = (/mob/living/simple_animal/chicken,/turf/open/floor/grass,/area/ruin/powered/beefcyto)
"zl" = (/obj/machinery/vending/hydronutrients{default_price = null; extra_price = null; fair_market_price = null},/turf/open/floor/plasteel/white,/area/ruin/powered/beefcyto)
"zn" = (/obj/structure/geyser,/turf/open/floor/plating/asteroid/snow/icemoon,/area/icemoon/underground/explored)
"zO" = (/obj/structure/flora/ash/chilly,/turf/open/floor/plating/asteroid/snow/atmosphere,/area/icemoon/underground/explored)
"AM" = (/obj/machinery/chem_dispenser/drinks/fullupgrade,/obj/structure/table/wood,/turf/open/floor/plasteel/white,/area/ruin/powered/beefcyto)
"AZ" = (/obj/structure/chair/sofa/corp/corner{dir = 1},/turf/open/floor/eighties,/area/ruin/powered/beefcyto)
"Ba" = (/obj/effect/turf_decal/trimline/blue/filled/corner{dir = 8},/turf/open/floor/plasteel/white,/area/ruin/powered/beefcyto)
"BB" = (/mob/living/simple_animal/chick,/turf/open/floor/grass,/area/ruin/powered/beefcyto)
"BP" = (/mob/living/simple_animal/cow,/turf/open/floor/grass,/area/ruin/powered/beefcyto)
"BT" = (/obj/machinery/gibber,/turf/open/floor/plasteel/kitchen_coldroom,/area/ruin/powered/beefcyto)
"BU" = (/turf/open/floor/plasteel/kitchen_coldroom,/area/ruin/powered/beefcyto)
"Cc" = (/turf/closed/mineral/snowmountain/cavern/icemoon,/area/icemoon/underground/explored)
"CC" = (/obj/effect/decal/cleanable/garbage,/turf/open/floor/plating/asteroid/snow/icemoon,/area/icemoon/underground/explored)
"CU" = (/mob/living/simple_animal/hostile/tree{health = 100},/turf/open/floor/plating/asteroid/snow/icemoon,/area/icemoon/underground/explored)
"Dy" = (/obj/machinery/button/door{id_tag = "carp door"; name = "carp door bolt"; normaldoorcontrol = 1; specialfunctions = 4},/turf/closed/wall/r_wall,/area/ruin/powered/beefcyto)
"DB" = (/obj/structure/fence/corner{dir = 6},/turf/open/floor/plating/asteroid/snow/icemoon,/area/icemoon/underground/explored)
"Fv" = (/obj/machinery/smartfridge/chemistry/preloaded,/turf/open/floor/plasteel/white,/area/ruin/powered/beefcyto)
"FR" = (/obj/structure/fans/tiny,/obj/machinery/door/airlock/public/glass,/turf/open/floor/plating,/area/ruin/powered/beefcyto)
"Gb" = (/obj/effect/turf_decal/trimline/blue/filled/line,/turf/open/floor/plasteel/white,/area/ruin/powered/beefcyto)
"Gn" = (/obj/structure/window/reinforced/spawner,/turf/open/floor/grass,/area/ruin/powered/beefcyto)
"Go" = (/obj/structure/chair/sofa/corp/right{dir = 8},/turf/open/floor/eighties,/area/ruin/powered/beefcyto)
"Hg" = (/obj/structure/table/reinforced,/obj/machinery/reagentgrinder,/turf/open/floor/plasteel/cafeteria,/area/ruin/powered/beefcyto)
"In" = (/obj/structure/table/wood,/obj/item/gun/energy/kinetic_accelerator,/obj/item/kitchen/knife/combat/survival,/obj/item/storage/firstaid/medical,/obj/effect/turf_decal/tile/red{dir = 8},/obj/effect/turf_decal/tile/red,/obj/effect/turf_decal/tile/red{dir = 4},/obj/effect/turf_decal/tile/red{dir = 1},/obj/item/pickaxe,/obj/item/flashlight/seclite,/turf/open/floor/plasteel/white,/area/ruin/powered/beefcyto)
"Ip" = (/obj/machinery/deepfryer,/turf/open/floor/plasteel/cafeteria,/area/ruin/powered/beefcyto)
"Is" = (/mob/living/simple_animal/pet/penguin/emperor/shamebrero,/turf/open/floor/plating/asteroid/snow/atmosphere,/area/icemoon/underground/explored)
"IO" = (/obj/structure/grille/broken,/turf/open/floor/plating,/area/ruin/powered/beefcyto)
"IT" = (/mob/living/simple_animal/mouse/gray,/turf/open/floor/plating,/area/ruin/powered/beefcyto)
"IU" = (/turf/open/floor/plasteel/cafeteria,/area/ruin/powered/beefcyto)
"Jp" = (/obj/effect/turf_decal/trimline/blue/filled/line{dir = 10},/obj/structure/table/reinforced,/obj/item/construction/plumbing,/turf/open/floor/plasteel/white,/area/ruin/powered/beefcyto)
"JF" = (/obj/structure/grille,/obj/structure/window/reinforced/fulltile/ice,/turf/open/floor/plating/snowed,/area/ruin/powered/beefcyto)
"JH" = (/mob/living/simple_animal/hostile/blob/blobbernaut/independent,/obj/machinery/light/floor,/turf/open/floor/mineral/plastitanium/red,/area/ruin/powered/beefcyto)
"JZ" = (/turf/open/floor/eighties,/area/ruin/powered/beefcyto)
"Kz" = (/obj/machinery/computer/pandemic,/obj/effect/turf_decal/trimline/green/filled/line{dir = 1},/turf/open/floor/plasteel/white,/area/ruin/powered/beefcyto)
"KT" = (/obj/effect/turf_decal/trimline/blue/filled/line{dir = 6},/obj/machinery/chem_heater,/turf/open/floor/plasteel/white,/area/ruin/powered/beefcyto)
"KU" = (/obj/effect/turf_decal/trimline/purple/filled/line{dir = 9},/turf/open/floor/plasteel/white,/area/ruin/powered/beefcyto)
"Lt" = (/obj/item/slimecross/chilling/gold,/obj/item/slimecross/chilling/gold,/obj/item/slimecross/chilling/gold,/obj/item/slimecross/chilling/gold,/obj/item/slimecross/chilling/gold,/obj/structure/table/reinforced,/obj/effect/turf_decal/trimline/purple/filled/line{dir = 1},/turf/open/floor/plasteel/white,/area/ruin/powered/beefcyto)
"LM" = (/obj/machinery/biogenerator,/turf/open/floor/plasteel/white,/area/ruin/powered/beefcyto)
"LP" = (/obj/structure/chair/sofa/corp/corner{dir = 8},/turf/open/floor/eighties,/area/ruin/powered/beefcyto)
"Mk" = (/obj/effect/turf_decal/trimline/green/filled/corner{dir = 4},/turf/open/floor/plasteel/white,/area/ruin/powered/beefcyto)
"MA" = (/obj/structure/fence{dir = 4},/obj/structure/fans/tiny/invisible,/turf/open/floor/plating/asteroid/snow/icemoon,/area/icemoon/underground/explored)
"MC" = (/obj/machinery/light{dir = 1},/obj/structure/moisture_trap,/obj/effect/turf_decal/trimline/green/filled/line{dir = 9},/turf/open/floor/plasteel/white,/area/ruin/powered/beefcyto)
"ME" = (/obj/machinery/door/airlock/public/glass,/obj/structure/fans/tiny,/turf/open/floor/plating,/area/ruin/powered/beefcyto)
"ML" = (/obj/structure/sign/warning,/turf/closed/wall/r_wall,/area/ruin/powered/beefcyto)
"Ne" = (/obj/effect/turf_decal/trimline/purple/filled/line{dir = 6},/turf/open/floor/plasteel/white,/area/ruin/powered/beefcyto)
"Nh" = (/obj/machinery/door/airlock/vault{id_tag = "migo door"; name = "migo door"},/obj/effect/mapping_helpers/airlock/locked,/turf/open/floor/mineral/plastitanium/red,/area/ruin/powered/beefcyto)
"Ob" = (/obj/machinery/light/floor,/turf/open/floor/mineral/plastitanium/red,/area/ruin/powered/beefcyto)
"Oh" = (/obj/effect/turf_decal/trimline/purple/filled/line{dir = 5},/turf/open/floor/plasteel/white,/area/ruin/powered/beefcyto)
"On" = (/turf/open/floor/plating/snowed,/area/icemoon/underground/explored)
"Ox" = (/mob/living/simple_animal/pet/penguin/baby,/turf/open/floor/plating/asteroid/snow/atmosphere,/area/icemoon/underground/explored)
"Pp" = (/obj/structure/fireplace{dir = 1},/turf/open/floor/plasteel/white,/area/ruin/powered/beefcyto)
"Py" = (/obj/effect/decal/cleanable/garbage,/turf/open/floor/plating,/area/ruin/powered/beefcyto)
"PB" = (/obj/effect/turf_decal/tile/red,/obj/effect/turf_decal/tile/red{dir = 8},/obj/effect/turf_decal/tile/red{dir = 1},/obj/effect/turf_decal/tile/red{dir = 4},/obj/machinery/light,/turf/open/floor/plasteel/white,/area/ruin/powered/beefcyto)
"PC" = (/obj/structure/table/reinforced,/obj/effect/turf_decal/trimline/green/filled/line{dir = 1},/obj/item/stack/sheet/mineral/plasma{amount = 5},/turf/open/floor/plasteel/white,/area/ruin/powered/beefcyto)
"Qk" = (/obj/structure/flora/ash/chilly,/turf/open/floor/plating/asteroid/snow/icemoon,/area/icemoon/underground/explored)
"Qy" = (/obj/effect/turf_decal/tile/blue{dir = 8},/obj/effect/turf_decal/tile/blue,/obj/effect/turf_decal/tile/blue{dir = 4},/obj/effect/turf_decal/tile/blue{dir = 1},/obj/machinery/light{dir = 8},/turf/open/floor/plasteel/white,/area/ruin/powered/beefcyto)
"QJ" = (/mob/living/simple_animal/mouse/brown,/turf/open/floor/plating,/area/ruin/powered/beefcyto)
"Rq" = (/obj/effect/turf_decal/trimline/purple/filled/line{dir = 4},/obj/machinery/light{dir = 4},/turf/open/floor/plasteel/white,/area/ruin/powered/beefcyto)
"Ru" = (/obj/machinery/door/window/westleft,/turf/open/floor/plasteel/kitchen_coldroom,/area/ruin/powered/beefcyto)
"Sp" = (/obj/structure/closet/emcloset/anchored,/turf/open/floor/plasteel/white,/area/ruin/powered/beefcyto)
"Su" = (/obj/machinery/smartfridge/chemistry/virology/preloaded,/turf/open/floor/plasteel/white,/area/ruin/powered/beefcyto)
"Sv" = (/obj/effect/turf_decal/trimline/purple/filled/line{dir = 1},/turf/open/floor/plasteel/white,/area/ruin/powered/beefcyto)
"Sx" = (/obj/machinery/vending/hydroseeds,/turf/open/floor/plasteel/white,/area/ruin/powered/beefcyto)
"SG" = (/obj/structure/fence,/turf/open/floor/plating/asteroid/snow/icemoon,/area/icemoon/underground/explored)
"Tf" = (/obj/machinery/door/airlock/vault{id_tag = "carp door"; name = "carp door"},/obj/effect/mapping_helpers/airlock/locked,/turf/open/floor/mineral/plastitanium/red,/area/ruin/powered/beefcyto)
"To" = (/mob/living/simple_animal/hostile/netherworld/migo,/obj/machinery/light/floor,/turf/open/floor/mineral/plastitanium/red,/area/ruin/powered/beefcyto)
"TJ" = (/obj/machinery/door/airlock/vault{id_tag = "blobbernaut door"; name = "blobbernaut door"},/obj/effect/mapping_helpers/airlock/locked,/turf/open/floor/mineral/plastitanium/red,/area/ruin/powered/beefcyto)
"TQ" = (/obj/structure/sign/warning/biohazard,/turf/closed/wall/r_wall,/area/ruin/powered/beefcyto)
"Ue" = (/obj/structure/closet/l3closet/virology,/obj/effect/turf_decal/trimline/blue/filled/line{dir = 6},/obj/machinery/light,/turf/open/floor/plasteel/white,/area/ruin/powered/beefcyto)
"Uj" = (/obj/structure/fence/door{open = 1},/turf/open/floor/plating/asteroid/snow/icemoon,/area/icemoon/underground/explored)
"Up" = (/turf/closed/wall,/area/ruin/powered/beefcyto)
"UA" = (/obj/structure/table/reinforced,/obj/machinery/reagentgrinder/constructed,/turf/open/floor/plasteel/white,/area/ruin/powered/beefcyto)
"Vs" = (/mob/living/simple_animal/hostile/carp,/obj/machinery/light/floor,/turf/open/floor/mineral/plastitanium/red,/area/ruin/powered/beefcyto)
"Vu" = (/obj/effect/turf_decal/trimline/green/filled/corner{dir = 1},/turf/open/floor/plasteel/white,/area/ruin/powered/beefcyto)
"Vv" = (/obj/structure/flora/grass/both,/turf/open/floor/plating/asteroid/snow/icemoon,/area/icemoon/underground/explored)
"VI" = (/obj/structure/flora/ash/chilly,/obj/structure/flora/rock/pile/icy,/turf/open/floor/plating/asteroid/snow/icemoon,/area/icemoon/underground/explored)
"Wh" = (/obj/structure/chair/sofa/corp/left{dir = 4},/mob/living/simple_animal/pet/dog/pug,/turf/open/floor/eighties,/area/ruin/powered/beefcyto)
"Wn" = (/obj/machinery/vending/dinnerware{default_price = null; extra_price = null; fair_market_price = null},/turf/open/floor/plasteel/cafeteria,/area/ruin/powered/beefcyto)
"WR" = (/obj/effect/turf_decal/trimline/green/filled/line{dir = 9},/turf/open/floor/plasteel/white,/area/ruin/powered/beefcyto)
"Xf" = (/obj/structure/table/wood,/obj/item/toy/cards/deck,/obj/item/lighter,/turf/open/floor/eighties,/area/ruin/powered/beefcyto)
"Xv" = (/obj/structure/reagent_dispensers/watertank/high,/turf/open/floor/plating,/area/ruin/powered/beefcyto)
"Xw" = (/obj/structure/closet/secure_closet/freezer/fridge,/obj/item/storage/box/papersack/meat,/turf/open/floor/plasteel/cafeteria,/area/ruin/powered/beefcyto)
"XC" = (/obj/effect/turf_decal/trimline/blue/filled/corner,/turf/open/floor/plasteel/white,/area/ruin/powered/beefcyto)
"XG" = (/obj/machinery/button/door{id_tag = "migo door"; name = "migo door bolt"; normaldoorcontrol = 1; specialfunctions = 4},/turf/closed/wall/r_wall,/area/ruin/powered/beefcyto)
"XH" = (/obj/machinery/light{dir = 1},/obj/structure/closet/secure_closet/cytology{req_access = null},/obj/effect/turf_decal/trimline/green/filled/line{dir = 5},/obj/item/clothing/suit/toggle/labcoat/science,/turf/open/floor/plasteel/white,/area/ruin/powered/beefcyto)
"XK" = (/obj/structure/closet/crate/trashcart,/turf/open/floor/plating,/area/ruin/powered/beefcyto)
"Yk" = (/obj/machinery/light{dir = 8},/turf/open/floor/grass,/area/ruin/powered/beefcyto)
"YF" = (/obj/structure/table/reinforced,/obj/structure/microscope,/turf/open/floor/plasteel/white,/area/ruin/powered/beefcyto)
"Zx" = (/obj/effect/turf_decal/trimline/purple/filled/line{dir = 10},/turf/open/floor/plasteel/white,/area/ruin/powered/beefcyto)
"ZI" = (/obj/machinery/light{dir = 4},/turf/open/floor/plasteel/cafeteria,/area/ruin/powered/beefcyto)

(1,1,1) = {"
CcCcCcCcCcCcCcCcCcCcCcCcCcCcCcCcCcCcCcCcCcCcCcCcCcCcCcCcCc
CcVvugugugugugugugugugwjugugugugugugugugugugugugugugVvugCc
CcugmYnPeenPnPnPeenPnPnPeenPnPnPeenPUjnPnPnPUjnPnPnPDBugCc
CcugSGugugugugCCqfugugQkugugugugSGugugugugugugugugugSGugCc
CcwjSGugbIbIMLioyDbIqfugugfYugiAszugugugqfugugfYugQkrYugCc
CcugSGugbIJHTJieiebIugugugugugugSGugugOnOnkKugugugugSGugCc
CcugSGugbIbIXGieiebIqfugugugugugSGugugbIuVbIugugugugSGugCc
CcugSGQkbIToNhieaXbIugugugugugugSGugqfbIxFbIqfugugoYSGugCc
CcugSGugbIbIDyieiebIqfugugQkugugbIJFJFbIMEbIJFJFbInPxDugCc
CcugSGugbIVsTfObiebIugugugugugugbIaffuSpfuSpfuafbIugugugCc
CcugSGugbIbIMLbIyDbIqfugugznugugbIQyndndndndndtbbIugugugCc
CcugSGugugugugugqfugugugugugugugbIInyiPByiPByiInbIugugugCc
CcugSGugugugugugugugugugQkugugdWbIJFJFbIMEbIJFJFbIugugugCc
CcugSGugVvugugugbIwwwwwwwwwwbISGgNiiiibIxFbIugwjugugugugCc
CcugSGugugugugbIbIWRrjKzPCxfbIbIiiiiIsbIITbIugugugugugugCc
CcugSGugugugugbIMCVufufufuMkXHbIhniiiibIxFbIugugugQkVvugCc
CcugbIbIbIbIbIbImDfufufufufusybIbIbIbIbIfUbIbIbIbIugugugCc
CcugbIvXxFxlFRrjVufudIbxSufuMkrjfUxlxFITxlxFPyvXbIugugugCc
CcugbIxFxFxFetGbBafuYFFvUAfuXCGbetxFxFxFIOxFxFprbIugugugCc
CcugbIQJxFbIbIbIiTfufufufufuyEbIbIbIbIbIbIbIbIxFbIugugugCc
CcugbIpTxFbIiibItWBafufufuXCUebIiiiiiiiiiiiibIxFbIwjugugCc
CcugbIXvxFbIiibIbIJpfBhUnHKTbIbIiiOxzOiitFiibIxFbIugugugCc
CcugbIXKxFbIiiiibIJFJFJFJFJFbIiiiiiiiiiitFiibIxFbIugugugCc
CcugbIvXtNTQaltFiiiiiiiiiiiiiiiiiiiiiiiiiialbIxlbIznugugCc
CcugbIetMEbIJFJFJFJFbIMAbIbIJFJFUpJFJFUpJFJFbIMEbIbIbIugCc
CcugbIKUSvSvLtLtSvOhbIugbIyXBBBBxgfufutAfufuuxfuvaAMbIugCc
CcugbIyVfufufufufujRbIugbIYkBPhLeffuWhXfGofufufufujnbIugCc
CcugbIuqfufufungfuRqbIugbIGnGnGnblfuAZelLPfufufufufubIugCc
CcugbIyVfufufunhfujRbIugbILMzldrSxfucxJZJZfuqpmnIphXbIugCc
CcugbIyVfufufufufujRbIugbIlvfufufufufufufufuIUIUIUZIbIugCc
CcVvbIZxosttttttosNebIugbIxoxolQxoxoPpbZfufurgHgXwWnbIugCc
CcugbIbIbIbIbIbIbIbIbIMAbIbIbIbIbIbIbIbIbIcYUpUpUpUpbIugCc
CcugugugugugQkugugugugugugugugugugugugugbIifBUgaeyBTbIugCc
CcugugugugugugugugugugugugugugugVIugugugbIpGRutsBUehbIugCc
CcugugugugugugugugugugugugugugugugugugugbIbIbIbIbIbIbIugCc
CcCCugscVvugscugQkCUugugscugugscugugugugugugugugugVvugugCc
CcCcCcCcCcCcCcCcCcCcCcCcCcCcCcCcCcCcCcCcCcCcCcCcCcCcCcCcCc
"}
