//MAP CONVERTED BY dmm2tgm.py THIS HEADER COMMENT PREVENTS RECONVERSION, DO NOT REMOVE
"ae" = (
/obj/effect/turf_decal/siding/yellow/end,
/turf/open/indestructible/dark/smooth_large,
/area/deathmatch/fullbright)
"bF" = (
/obj/effect/turf_decal/siding/blue/corner{
	dir = 4
	},
/turf/open/indestructible/dark/smooth_large,
/area/deathmatch/fullbright)
"bV" = (
/obj/effect/turf_decal/siding/yellow/corner{
	dir = 1
	},
/obj/effect/turf_decal/siding/yellow/corner{
	dir = 8
	},
/turf/open/indestructible/large,
/area/deathmatch/fullbright)
"cu" = (
/obj/effect/turf_decal/siding/dark_red{
	dir = 6
	},
/turf/open/indestructible/dark/smooth_large,
/area/deathmatch/fullbright)
"eb" = (
/obj/effect/turf_decal/siding/dark_green/corner{
	dir = 1
	},
/turf/open/indestructible/dark/smooth_large,
/area/deathmatch/fullbright)
"eN" = (
/obj/effect/landmark/deathmatch_player_spawn,
/obj/effect/turf_decal/siding/dark_green/corner{
	dir = 1
	},
/turf/open/indestructible/large,
/area/deathmatch/fullbright)
"fp" = (
/obj/effect/turf_decal/siding/dark_green/end{
	dir = 8
	},
/turf/open/indestructible/dark/smooth_large,
/area/deathmatch/fullbright)
"gs" = (
/obj/effect/turf_decal/siding/blue/end{
	dir = 1
	},
/turf/open/indestructible/dark/smooth_large,
/area/deathmatch/fullbright)
"hk" = (
/obj/effect/landmark/deathmatch_player_spawn,
/obj/effect/turf_decal/siding/dark_red/corner,
/turf/open/indestructible/large,
/area/deathmatch/fullbright)
"jb" = (
/obj/effect/turf_decal/siding/blue{
	dir = 4
	},
/turf/open/indestructible/dark/smooth_large,
/area/deathmatch/fullbright)
"jl" = (
/obj/effect/turf_decal/siding/blue,
/obj/effect/turf_decal/siding/blue{
	dir = 1
	},
/turf/open/indestructible/dark/smooth_large,
/area/deathmatch/fullbright)
"kR" = (
/turf/open/chasm,
/area/deathmatch/fullbright)
"kS" = (
/obj/effect/turf_decal/siding/dark_green{
	dir = 4
	},
/obj/effect/turf_decal/siding/dark_green{
	dir = 8
	},
/turf/open/indestructible/dark/smooth_large,
/area/deathmatch/fullbright)
"lJ" = (
/obj/effect/turf_decal/siding/dark_red{
	dir = 8
	},
/obj/effect/turf_decal/siding/dark_red{
	dir = 4
	},
/turf/open/indestructible/large,
/area/deathmatch/fullbright)
"ok" = (
/obj/effect/turf_decal/siding/dark_red/end{
	dir = 4
	},
/turf/open/indestructible/dark/smooth_large,
/area/deathmatch/fullbright)
"os" = (
/obj/effect/turf_decal/siding/dark_green,
/obj/effect/turf_decal/siding/dark_green{
	dir = 1
	},
/turf/open/indestructible/dark/smooth_large,
/area/deathmatch/fullbright)
"ou" = (
/obj/effect/turf_decal/siding/dark_green/corner{
	dir = 4
	},
/obj/effect/turf_decal/siding/dark_green/corner{
	dir = 1
	},
/turf/open/indestructible/large,
/area/deathmatch/fullbright)
"oE" = (
/obj/effect/turf_decal/siding/dark_red{
	dir = 1
	},
/obj/effect/turf_decal/siding/dark_red,
/turf/open/indestructible/large,
/area/deathmatch/fullbright)
"oX" = (
/obj/effect/turf_decal/siding/blue{
	dir = 1
	},
/turf/open/indestructible/dark/smooth_large,
/area/deathmatch/fullbright)
"pg" = (
/obj/effect/turf_decal/siding/dark_green{
	dir = 1
	},
/turf/open/indestructible/large,
/area/deathmatch/fullbright)
"pE" = (
/obj/effect/turf_decal/siding/dark_green,
/obj/effect/turf_decal/siding/dark_green{
	dir = 1
	},
/turf/open/indestructible/large,
/area/deathmatch/fullbright)
"qg" = (
/obj/effect/turf_decal/siding/dark_green{
	dir = 8
	},
/turf/open/indestructible/dark/smooth_large,
/area/deathmatch/fullbright)
"qm" = (
/obj/effect/turf_decal/siding/yellow,
/turf/open/indestructible/large,
/area/deathmatch/fullbright)
"rS" = (
/obj/effect/turf_decal/siding/dark_red/end,
/turf/open/indestructible/dark/smooth_large,
/area/deathmatch/fullbright)
"sb" = (
/obj/effect/turf_decal/siding/yellow/end{
	dir = 8
	},
/turf/open/indestructible/dark/smooth_large,
/area/deathmatch/fullbright)
"sL" = (
/obj/effect/turf_decal/siding/yellow/corner{
	dir = 8
	},
/obj/effect/turf_decal/siding/yellow{
	dir = 5
	},
/turf/open/indestructible/dark/smooth_large,
/area/deathmatch/fullbright)
"ud" = (
/obj/effect/landmark/deathmatch_player_spawn,
/obj/effect/turf_decal/siding/blue/corner{
	dir = 4
	},
/turf/open/indestructible/large,
/area/deathmatch/fullbright)
"vn" = (
/obj/effect/turf_decal/siding/blue{
	dir = 8
	},
/obj/effect/turf_decal/siding/blue{
	dir = 4
	},
/turf/open/indestructible/dark/smooth_large,
/area/deathmatch/fullbright)
"vz" = (
/obj/effect/turf_decal/siding/blue/corner,
/obj/effect/turf_decal/siding/blue/corner{
	dir = 4
	},
/turf/open/indestructible/large,
/area/deathmatch/fullbright)
"vF" = (
/obj/effect/turf_decal/siding/dark_red,
/turf/open/indestructible/large,
/area/deathmatch/fullbright)
"vV" = (
/obj/effect/turf_decal/siding/blue/corner{
	dir = 1
	},
/obj/effect/turf_decal/siding/blue/corner{
	dir = 4
	},
/turf/open/indestructible/large,
/area/deathmatch/fullbright)
"wl" = (
/obj/effect/turf_decal/siding/blue{
	dir = 1
	},
/turf/open/indestructible/large,
/area/deathmatch/fullbright)
"xc" = (
/obj/structure/lattice/catwalk/mining,
/turf/open/chasm,
/area/deathmatch/fullbright)
"xv" = (
/obj/effect/turf_decal/siding/dark_red/corner{
	dir = 8
	},
/obj/effect/turf_decal/siding/dark_red/corner,
/turf/open/indestructible/large,
/area/deathmatch/fullbright)
"xQ" = (
/obj/effect/turf_decal/siding/blue{
	dir = 10
	},
/obj/effect/turf_decal/siding/blue/corner{
	dir = 4
	},
/turf/open/indestructible/dark/smooth_large,
/area/deathmatch/fullbright)
"zB" = (
/obj/effect/turf_decal/siding/yellow/corner{
	dir = 4
	},
/obj/effect/turf_decal/siding/yellow{
	dir = 10
	},
/turf/open/indestructible/large,
/area/deathmatch/fullbright)
"AS" = (
/obj/effect/turf_decal/siding/dark_green{
	dir = 8
	},
/turf/open/indestructible/large,
/area/deathmatch/fullbright)
"Bz" = (
/obj/effect/turf_decal/siding/blue/end{
	dir = 4
	},
/turf/open/indestructible/dark/smooth_large,
/area/deathmatch/fullbright)
"Cj" = (
/obj/effect/turf_decal/siding/dark_red{
	dir = 4
	},
/turf/open/indestructible/dark/smooth_large,
/area/deathmatch/fullbright)
"Cw" = (
/obj/effect/turf_decal/siding/dark_red/corner{
	dir = 4
	},
/obj/effect/turf_decal/siding/dark_red/corner,
/turf/open/indestructible/large,
/area/deathmatch/fullbright)
"CE" = (
/obj/effect/turf_decal/siding/dark_red,
/obj/effect/turf_decal/siding/dark_red{
	dir = 1
	},
/turf/open/indestructible/dark/smooth_large,
/area/deathmatch/fullbright)
"Dc" = (
/obj/effect/turf_decal/siding/yellow{
	dir = 1
	},
/obj/effect/turf_decal/siding/yellow,
/turf/open/indestructible/large,
/area/deathmatch/fullbright)
"Df" = (
/obj/effect/turf_decal/siding/yellow{
	dir = 10
	},
/turf/open/indestructible/dark/smooth_large,
/area/deathmatch/fullbright)
"Ei" = (
/obj/effect/turf_decal/siding/dark_red/corner,
/turf/open/indestructible/dark/smooth_large,
/area/deathmatch/fullbright)
"Es" = (
/obj/effect/turf_decal/siding/dark_green{
	dir = 1
	},
/turf/open/indestructible/dark/smooth_large,
/area/deathmatch/fullbright)
"Fd" = (
/turf/open/indestructible/light,
/area/deathmatch/fullbright)
"Ge" = (
/obj/effect/turf_decal/siding/yellow{
	dir = 4
	},
/obj/effect/turf_decal/siding/yellow{
	dir = 8
	},
/turf/open/indestructible/large,
/area/deathmatch/fullbright)
"Hg" = (
/obj/effect/turf_decal/siding/yellow{
	dir = 8
	},
/turf/open/indestructible/large,
/area/deathmatch/fullbright)
"Hm" = (
/obj/effect/landmark/deathmatch_player_spawn,
/obj/effect/turf_decal/siding/yellow/corner{
	dir = 8
	},
/turf/open/indestructible/large,
/area/deathmatch/fullbright)
"HM" = (
/obj/effect/turf_decal/siding/dark_red{
	dir = 4
	},
/obj/effect/turf_decal/siding/dark_red{
	dir = 8
	},
/turf/open/indestructible/dark/smooth_large,
/area/deathmatch/fullbright)
"Ij" = (
/obj/effect/turf_decal/siding/dark_green/end{
	dir = 1
	},
/turf/open/indestructible/dark/smooth_large,
/area/deathmatch/fullbright)
"IP" = (
/obj/effect/turf_decal/siding/dark_green/corner,
/obj/effect/turf_decal/siding/dark_green{
	dir = 9
	},
/turf/open/indestructible/large,
/area/deathmatch/fullbright)
"Jq" = (
/obj/effect/turf_decal/siding/blue,
/obj/effect/turf_decal/siding/blue{
	dir = 1
	},
/turf/open/indestructible/large,
/area/deathmatch/fullbright)
"JS" = (
/obj/effect/turf_decal/siding/blue{
	dir = 5
	},
/turf/open/indestructible/dark/smooth_large,
/area/deathmatch/fullbright)
"Kn" = (
/turf/open/chasm,
/area/space)
"Ks" = (
/obj/effect/turf_decal/siding/yellow/corner{
	dir = 8
	},
/turf/open/indestructible/dark/smooth_large,
/area/deathmatch/fullbright)
"LY" = (
/obj/effect/turf_decal/siding/blue/corner{
	dir = 8
	},
/obj/effect/turf_decal/siding/blue{
	dir = 5
	},
/turf/open/indestructible/large,
/area/deathmatch/fullbright)
"NE" = (
/obj/effect/turf_decal/siding/dark_red/corner{
	dir = 1
	},
/obj/effect/turf_decal/siding/dark_red{
	dir = 6
	},
/turf/open/indestructible/large,
/area/deathmatch/fullbright)
"NN" = (
/obj/effect/turf_decal/siding/dark_red{
	dir = 4
	},
/turf/open/indestructible/large,
/area/deathmatch/fullbright)
"Qn" = (
/obj/effect/turf_decal/siding/dark_green{
	dir = 4
	},
/obj/effect/turf_decal/siding/dark_green{
	dir = 8
	},
/turf/open/indestructible/large,
/area/deathmatch/fullbright)
"Qy" = (
/obj/effect/turf_decal/siding/yellow/corner,
/obj/effect/turf_decal/siding/yellow/corner{
	dir = 8
	},
/turf/open/indestructible/large,
/area/deathmatch/fullbright)
"QA" = (
/obj/effect/turf_decal/siding/blue{
	dir = 4
	},
/turf/open/indestructible/large,
/area/deathmatch/fullbright)
"QR" = (
/obj/effect/turf_decal/siding/yellow,
/obj/effect/turf_decal/siding/yellow{
	dir = 1
	},
/turf/open/indestructible/dark/smooth_large,
/area/deathmatch/fullbright)
"TA" = (
/obj/effect/turf_decal/siding/yellow,
/turf/open/indestructible/dark/smooth_large,
/area/deathmatch/fullbright)
"Vh" = (
/obj/effect/turf_decal/siding/yellow{
	dir = 8
	},
/turf/open/indestructible/dark/smooth_large,
/area/deathmatch/fullbright)
"Vn" = (
/obj/effect/turf_decal/siding/dark_green{
	dir = 6
	},
/obj/effect/turf_decal/siding/dark_green/corner{
	dir = 1
	},
/turf/open/indestructible/dark/smooth_large,
/area/deathmatch/fullbright)
"VH" = (
/obj/effect/turf_decal/siding/dark_green/corner{
	dir = 8
	},
/obj/effect/turf_decal/siding/dark_green/corner{
	dir = 1
	},
/turf/open/indestructible/large,
/area/deathmatch/fullbright)
"VK" = (
/obj/effect/turf_decal/siding/dark_red,
/turf/open/indestructible/dark/smooth_large,
/area/deathmatch/fullbright)
"Wr" = (
/obj/effect/turf_decal/siding/dark_green{
	dir = 9
	},
/turf/open/indestructible/dark/smooth_large,
/area/deathmatch/fullbright)
"Wz" = (
/obj/effect/turf_decal/siding/dark_red/corner,
/obj/effect/turf_decal/siding/dark_red{
	dir = 9
	},
/turf/open/indestructible/dark/smooth_large,
/area/deathmatch/fullbright)
"XR" = (
/obj/effect/turf_decal/siding/blue{
	dir = 8
	},
/obj/effect/turf_decal/siding/blue{
	dir = 4
	},
/turf/open/indestructible/large,
/area/deathmatch/fullbright)
"Yd" = (
/obj/effect/turf_decal/siding/yellow{
	dir = 8
	},
/obj/effect/turf_decal/siding/yellow{
	dir = 4
	},
/turf/open/indestructible/dark/smooth_large,
/area/deathmatch/fullbright)

(1,1,1) = {"
Kn
Kn
Kn
Kn
Kn
Kn
Kn
Kn
Kn
Kn
Kn
Kn
Kn
Kn
Kn
Kn
Kn
Kn
Kn
Kn
Kn
Kn
Kn
Kn
Kn
Kn
Kn
Kn
Kn
Kn
Kn
Kn
Kn
Kn
Kn
Kn
Kn
Kn
Kn
Kn
"}
(2,1,1) = {"
Kn
Kn
Kn
Kn
Kn
Kn
Kn
Kn
Kn
Kn
Kn
Kn
Kn
Kn
Kn
Kn
Kn
Kn
Kn
Kn
Kn
Kn
Kn
Kn
Kn
Kn
Kn
Kn
Kn
Kn
Kn
Kn
Kn
Kn
Kn
Kn
Kn
Kn
Kn
Kn
"}
(3,1,1) = {"
Kn
Kn
Kn
Kn
Kn
Kn
Kn
Kn
Kn
Kn
Kn
Kn
Kn
Kn
Kn
Kn
Kn
Kn
Kn
Kn
Kn
Kn
Kn
Kn
Kn
Kn
Kn
Kn
Kn
Kn
Kn
Kn
Kn
Kn
Kn
Kn
Kn
Kn
Kn
Kn
"}
(4,1,1) = {"
Kn
Kn
Kn
Kn
Kn
Kn
Kn
Kn
Kn
Kn
Kn
Kn
Kn
Kn
Kn
Kn
Kn
Kn
Kn
Kn
Kn
Kn
Kn
Kn
Kn
Kn
Kn
Kn
Kn
Kn
Kn
Kn
Kn
Kn
Kn
Kn
Kn
Kn
Kn
Kn
"}
(5,1,1) = {"
Kn
Kn
Kn
Kn
Kn
Kn
Kn
Kn
Kn
Kn
Kn
Kn
Kn
Kn
Kn
Kn
Kn
Kn
Kn
Kn
Kn
Kn
Kn
Kn
Kn
Kn
Kn
Kn
Kn
Kn
Kn
Kn
Kn
Kn
Kn
Kn
Kn
Kn
Kn
Kn
"}
(6,1,1) = {"
Kn
Kn
Kn
Kn
Kn
Kn
Kn
Kn
Kn
Kn
Kn
Kn
Kn
Kn
Kn
Kn
Kn
Kn
Kn
Kn
Kn
Kn
Kn
Kn
Kn
Kn
Kn
Kn
Kn
Kn
Kn
Kn
Kn
Kn
Kn
Kn
Kn
Kn
Kn
Kn
"}
(7,1,1) = {"
Kn
Kn
Kn
Kn
Kn
Kn
Kn
Kn
Kn
Kn
Kn
Kn
Kn
Kn
Kn
Kn
Kn
Kn
Kn
Kn
Kn
Kn
Kn
Kn
Kn
Kn
Kn
Kn
Kn
Kn
Kn
Kn
Kn
Kn
Kn
Kn
Kn
Kn
Kn
Kn
"}
(8,1,1) = {"
Kn
Kn
Kn
Kn
Kn
Kn
Kn
Kn
Kn
Kn
Kn
Kn
Kn
Kn
Kn
Kn
Kn
Kn
Kn
Kn
Kn
Kn
Kn
Kn
Kn
Kn
Kn
Kn
Kn
Kn
Kn
Kn
Kn
Kn
Kn
Kn
Kn
Kn
Kn
Kn
"}
(9,1,1) = {"
Kn
Kn
Kn
Kn
Kn
Kn
Kn
Kn
Kn
Kn
Kn
Kn
Kn
Kn
Kn
Kn
Kn
Kn
Kn
Kn
Kn
Kn
Kn
Kn
Kn
Kn
Kn
Kn
Kn
Kn
Kn
Kn
Kn
Kn
Kn
Kn
Kn
Kn
Kn
Kn
"}
(10,1,1) = {"
Kn
Kn
Kn
Kn
Kn
Kn
Kn
Kn
Kn
Fd
Fd
Fd
Fd
Fd
Fd
Fd
Fd
Fd
Fd
kR
kR
Fd
Fd
Fd
Fd
Fd
Fd
Fd
Fd
Fd
Fd
Kn
Kn
Kn
Kn
Kn
Kn
Kn
Kn
Kn
"}
(11,1,1) = {"
Kn
Kn
Kn
Kn
Kn
Kn
Kn
Kn
Kn
Fd
Wz
HM
HM
HM
HM
HM
HM
HM
rS
Fd
Fd
gs
vn
vn
vn
vn
vn
vn
vn
xQ
Fd
Kn
Kn
Kn
Kn
Kn
Kn
Kn
Kn
Kn
"}
(12,1,1) = {"
Kn
Kn
Kn
Kn
Kn
Kn
Kn
Kn
Kn
Fd
CE
hk
NN
NN
NN
NN
NN
NN
Cw
NN
QA
vz
QA
QA
QA
QA
QA
QA
ud
jl
Fd
Kn
Kn
Kn
Kn
Kn
Kn
Kn
Kn
Kn
"}
(13,1,1) = {"
Kn
Kn
Kn
Kn
Kn
Kn
Kn
Kn
Kn
Fd
CE
vF
Fd
xc
xc
xc
xc
Fd
oE
Ei
bF
Jq
Fd
xc
xc
xc
xc
Fd
wl
jl
Fd
Kn
Kn
Kn
Kn
Kn
Kn
Kn
Kn
Kn
"}
(14,1,1) = {"
Kn
Kn
Kn
Kn
Kn
Kn
Kn
Kn
Kn
Fd
CE
vF
xc
kR
kR
kR
kR
xc
oE
VK
oX
Jq
xc
kR
kR
kR
kR
xc
wl
jl
Fd
Kn
Kn
Kn
Kn
Kn
Kn
Kn
Kn
Kn
"}
(15,1,1) = {"
Kn
Kn
Kn
Kn
Kn
Kn
Kn
Kn
Kn
Fd
CE
vF
xc
kR
kR
kR
kR
xc
oE
VK
oX
Jq
xc
kR
kR
kR
kR
xc
wl
jl
Fd
Kn
Kn
Kn
Kn
Kn
Kn
Kn
Kn
Kn
"}
(16,1,1) = {"
Kn
Kn
Kn
Kn
Kn
Kn
Kn
Kn
Kn
Fd
CE
vF
xc
kR
kR
kR
kR
xc
oE
VK
oX
Jq
xc
kR
kR
kR
kR
xc
wl
jl
Fd
Kn
Kn
Kn
Kn
Kn
Kn
Kn
Kn
Kn
"}
(17,1,1) = {"
Kn
Kn
Kn
Kn
Kn
Kn
Kn
Kn
Kn
Fd
CE
vF
xc
kR
kR
kR
kR
xc
oE
VK
oX
Jq
xc
kR
kR
kR
kR
xc
wl
jl
Fd
Kn
Kn
Kn
Kn
Kn
Kn
Kn
Kn
Kn
"}
(18,1,1) = {"
Kn
Kn
Kn
Kn
Kn
Kn
Kn
Kn
Kn
Fd
CE
vF
Fd
xc
xc
xc
xc
Fd
oE
VK
oX
Jq
Fd
xc
xc
xc
xc
Fd
wl
jl
Fd
Kn
Kn
Kn
Kn
Kn
Kn
Kn
Kn
Kn
"}
(19,1,1) = {"
Kn
Kn
Kn
Kn
Kn
Kn
Kn
Kn
Kn
Fd
ok
xv
lJ
lJ
lJ
lJ
lJ
lJ
NE
VK
oX
LY
XR
XR
XR
XR
XR
XR
vV
Bz
Fd
Kn
Kn
Kn
Kn
Kn
Kn
Kn
Kn
Kn
"}
(20,1,1) = {"
Kn
Kn
Kn
Kn
Kn
Kn
Kn
Kn
Kn
kR
Fd
vF
Ei
Cj
Cj
Cj
Cj
Cj
Cj
cu
JS
jb
jb
jb
jb
jb
jb
bF
wl
Fd
kR
Kn
Kn
Kn
Kn
Kn
Kn
Kn
Kn
Kn
"}
(21,1,1) = {"
Kn
Kn
Kn
Kn
Kn
Kn
Kn
Kn
Kn
kR
Fd
qm
Ks
Vh
Vh
Vh
Vh
Vh
Vh
Df
Wr
qg
qg
qg
qg
qg
qg
eb
pg
Fd
kR
Kn
Kn
Kn
Kn
Kn
Kn
Kn
Kn
Kn
"}
(22,1,1) = {"
Kn
Kn
Kn
Kn
Kn
Kn
Kn
Kn
Kn
Fd
sb
Qy
Ge
Ge
Ge
Ge
Ge
Ge
zB
TA
Es
IP
Qn
Qn
Qn
Qn
Qn
Qn
ou
fp
Fd
Kn
Kn
Kn
Kn
Kn
Kn
Kn
Kn
Kn
"}
(23,1,1) = {"
Kn
Kn
Kn
Kn
Kn
Kn
Kn
Kn
Kn
Fd
QR
qm
Fd
xc
xc
xc
xc
Fd
Dc
TA
Es
pE
Fd
xc
xc
xc
xc
Fd
pg
os
Fd
Kn
Kn
Kn
Kn
Kn
Kn
Kn
Kn
Kn
"}
(24,1,1) = {"
Kn
Kn
Kn
Kn
Kn
Kn
Kn
Kn
Kn
Fd
QR
qm
xc
kR
kR
kR
kR
xc
Dc
TA
Es
pE
xc
kR
kR
kR
kR
xc
pg
os
Fd
Kn
Kn
Kn
Kn
Kn
Kn
Kn
Kn
Kn
"}
(25,1,1) = {"
Kn
Kn
Kn
Kn
Kn
Kn
Kn
Kn
Kn
Fd
QR
qm
xc
kR
kR
kR
kR
xc
Dc
TA
Es
pE
xc
kR
kR
kR
kR
xc
pg
os
Fd
Kn
Kn
Kn
Kn
Kn
Kn
Kn
Kn
Kn
"}
(26,1,1) = {"
Kn
Kn
Kn
Kn
Kn
Kn
Kn
Kn
Kn
Fd
QR
qm
xc
kR
kR
kR
kR
xc
Dc
TA
Es
pE
xc
kR
kR
kR
kR
xc
pg
os
Fd
Kn
Kn
Kn
Kn
Kn
Kn
Kn
Kn
Kn
"}
(27,1,1) = {"
Kn
Kn
Kn
Kn
Kn
Kn
Kn
Kn
Kn
Fd
QR
qm
xc
kR
kR
kR
kR
xc
Dc
TA
Es
pE
xc
kR
kR
kR
kR
xc
pg
os
Fd
Kn
Kn
Kn
Kn
Kn
Kn
Kn
Kn
Kn
"}
(28,1,1) = {"
Kn
Kn
Kn
Kn
Kn
Kn
Kn
Kn
Kn
Fd
QR
qm
Fd
xc
xc
xc
xc
Fd
Dc
Ks
eb
pE
Fd
xc
xc
xc
xc
Fd
pg
os
Fd
Kn
Kn
Kn
Kn
Kn
Kn
Kn
Kn
Kn
"}
(29,1,1) = {"
Kn
Kn
Kn
Kn
Kn
Kn
Kn
Kn
Kn
Fd
QR
Hm
Hg
Hg
Hg
Hg
Hg
Hg
bV
Hg
AS
VH
AS
AS
AS
AS
AS
AS
eN
os
Fd
Kn
Kn
Kn
Kn
Kn
Kn
Kn
Kn
Kn
"}
(30,1,1) = {"
Kn
Kn
Kn
Kn
Kn
Kn
Kn
Kn
Kn
Fd
sL
Yd
Yd
Yd
Yd
Yd
Yd
Yd
ae
Fd
Fd
Ij
kS
kS
kS
kS
kS
kS
kS
Vn
Fd
Kn
Kn
Kn
Kn
Kn
Kn
Kn
Kn
Kn
"}
(31,1,1) = {"
Kn
Kn
Kn
Kn
Kn
Kn
Kn
Kn
Kn
Fd
Fd
Fd
Fd
Fd
Fd
Fd
Fd
Fd
Fd
kR
kR
Fd
Fd
Fd
Fd
Fd
Fd
Fd
Fd
Fd
Fd
Kn
Kn
Kn
Kn
Kn
Kn
Kn
Kn
Kn
"}
(32,1,1) = {"
Kn
Kn
Kn
Kn
Kn
Kn
Kn
Kn
Kn
Kn
Kn
Kn
Kn
Kn
Kn
Kn
Kn
Kn
Kn
Kn
Kn
Kn
Kn
Kn
Kn
Kn
Kn
Kn
Kn
Kn
Kn
Kn
Kn
Kn
Kn
Kn
Kn
Kn
Kn
Kn
"}
(33,1,1) = {"
Kn
Kn
Kn
Kn
Kn
Kn
Kn
Kn
Kn
Kn
Kn
Kn
Kn
Kn
Kn
Kn
Kn
Kn
Kn
Kn
Kn
Kn
Kn
Kn
Kn
Kn
Kn
Kn
Kn
Kn
Kn
Kn
Kn
Kn
Kn
Kn
Kn
Kn
Kn
Kn
"}
(34,1,1) = {"
Kn
Kn
Kn
Kn
Kn
Kn
Kn
Kn
Kn
Kn
Kn
Kn
Kn
Kn
Kn
Kn
Kn
Kn
Kn
Kn
Kn
Kn
Kn
Kn
Kn
Kn
Kn
Kn
Kn
Kn
Kn
Kn
Kn
Kn
Kn
Kn
Kn
Kn
Kn
Kn
"}
(35,1,1) = {"
Kn
Kn
Kn
Kn
Kn
Kn
Kn
Kn
Kn
Kn
Kn
Kn
Kn
Kn
Kn
Kn
Kn
Kn
Kn
Kn
Kn
Kn
Kn
Kn
Kn
Kn
Kn
Kn
Kn
Kn
Kn
Kn
Kn
Kn
Kn
Kn
Kn
Kn
Kn
Kn
"}
(36,1,1) = {"
Kn
Kn
Kn
Kn
Kn
Kn
Kn
Kn
Kn
Kn
Kn
Kn
Kn
Kn
Kn
Kn
Kn
Kn
Kn
Kn
Kn
Kn
Kn
Kn
Kn
Kn
Kn
Kn
Kn
Kn
Kn
Kn
Kn
Kn
Kn
Kn
Kn
Kn
Kn
Kn
"}
(37,1,1) = {"
Kn
Kn
Kn
Kn
Kn
Kn
Kn
Kn
Kn
Kn
Kn
Kn
Kn
Kn
Kn
Kn
Kn
Kn
Kn
Kn
Kn
Kn
Kn
Kn
Kn
Kn
Kn
Kn
Kn
Kn
Kn
Kn
Kn
Kn
Kn
Kn
Kn
Kn
Kn
Kn
"}
(38,1,1) = {"
Kn
Kn
Kn
Kn
Kn
Kn
Kn
Kn
Kn
Kn
Kn
Kn
Kn
Kn
Kn
Kn
Kn
Kn
Kn
Kn
Kn
Kn
Kn
Kn
Kn
Kn
Kn
Kn
Kn
Kn
Kn
Kn
Kn
Kn
Kn
Kn
Kn
Kn
Kn
Kn
"}
(39,1,1) = {"
Kn
Kn
Kn
Kn
Kn
Kn
Kn
Kn
Kn
Kn
Kn
Kn
Kn
Kn
Kn
Kn
Kn
Kn
Kn
Kn
Kn
Kn
Kn
Kn
Kn
Kn
Kn
Kn
Kn
Kn
Kn
Kn
Kn
Kn
Kn
Kn
Kn
Kn
Kn
Kn
"}
(40,1,1) = {"
Kn
Kn
Kn
Kn
Kn
Kn
Kn
Kn
Kn
Kn
Kn
Kn
Kn
Kn
Kn
Kn
Kn
Kn
Kn
Kn
Kn
Kn
Kn
Kn
Kn
Kn
Kn
Kn
Kn
Kn
Kn
Kn
Kn
Kn
Kn
Kn
Kn
Kn
Kn
Kn
"}
