//MAP CONVERTED BY dmm2tgm.py THIS HEADER COMMENT PREVENTS RECONVERSION, DO NOT REMOVE
"ae" = (
/obj/structure/flora/ash/stem_shroom,
/turf/open/misc/dirt/jungle/wasteland,
/area/deathmatch/fullbright)
"ai" = (
/obj/structure/firepit,
/turf/open/floor/grass,
/area/deathmatch/fullbright)
"aN" = (
/obj/structure/flora/grass/jungle,
/turf/open/misc/grass/jungle,
/area/deathmatch/fullbright)
"bu" = (
/obj/structure/flora/grass/jungle/b/style_random,
/turf/open/misc/grass/jungle,
/area/deathmatch/fullbright)
"bZ" = (
/obj/structure/closet/crate/wooden,
/obj/item/gorilla_serum,
/obj/structure/window/spawner/directional/north,
/obj/structure/window/spawner/directional/south,
/obj/structure/window/spawner/directional/east,
/obj/structure/window/spawner/directional/west,
/turf/open/floor/vault/rock,
/area/deathmatch/fullbright)
"cw" = (
/obj/structure/closet/mini_fridge/grimy,
/obj/item/reagent_containers/cup/soda_cans/monkey_energy,
/turf/open/floor/wood,
/area/deathmatch/fullbright)
"cL" = (
/obj/structure/flora/grass/jungle/b/style_5,
/obj/structure/flora/grass/jungle,
/turf/open/misc/grass/jungle,
/area/deathmatch/fullbright)
"dk" = (
/obj/structure/flora/bush/lavendergrass,
/obj/item/spear/bonespear,
/turf/open/misc/dirt/jungle,
/area/deathmatch/fullbright)
"dn" = (
/obj/structure/flora/tree/jungle/small/style_random,
/turf/open/floor/grass,
/area/deathmatch/fullbright)
"dO" = (
/turf/open/floor/holofloor/beach/water,
/area/deathmatch/fullbright)
"dX" = (
/obj/structure/flora/bush/jungle/b,
/turf/open/floor/grass,
/area/deathmatch/fullbright)
"fK" = (
/obj/structure/flora/bush/jungle/b/style_2,
/obj/item/food/grown/banana,
/turf/open/misc/grass/jungle,
/area/deathmatch/fullbright)
"gz" = (
/mob/living/basic/gorilla,
/obj/structure/window/spawner/directional/south,
/obj/structure/window/spawner/directional/west,
/turf/open/floor/grass,
/area/deathmatch/fullbright)
"gS" = (
/obj/structure/flora/rock/style_2,
/turf/open/misc/dirt/jungle,
/area/deathmatch/fullbright)
"ha" = (
/obj/structure/flora/rock/pile/style_2,
/turf/open/misc/beach/sand,
/area/deathmatch/fullbright)
"hQ" = (
/obj/effect/landmark/deathmatch_player_spawn,
/turf/open/misc/dirt/jungle,
/area/deathmatch/fullbright)
"iO" = (
/obj/structure/flora/bush/grassy,
/obj/item/food/grown/banana/bluespace,
/turf/open/floor/grass,
/area/deathmatch/fullbright)
"iY" = (
/obj/structure/flora/grass/jungle/a,
/turf/open/misc/grass/jungle,
/area/deathmatch/fullbright)
"jo" = (
/obj/structure/flora/tree/jungle/small,
/turf/open/misc/grass/jungle,
/area/deathmatch/fullbright)
"jL" = (
/obj/structure/flora/grass/jungle/b/style_random,
/obj/structure/flora/grass/jungle/b/style_5,
/turf/open/misc/grass/jungle,
/area/deathmatch/fullbright)
"kr" = (
/obj/effect/landmark/deathmatch_player_spawn,
/turf/open/misc/beach/sand,
/area/deathmatch/fullbright)
"lI" = (
/turf/open/misc/dirt/jungle,
/area/deathmatch/fullbright)
"my" = (
/obj/structure/flora/bush/jungle/b/style_2,
/turf/open/floor/grass,
/area/deathmatch/fullbright)
"mY" = (
/obj/structure/flora/rock/style_3,
/turf/open/misc/dirt/jungle,
/area/deathmatch/fullbright)
"nh" = (
/obj/item/food/grown/banana,
/turf/open/misc/grass/jungle,
/area/deathmatch/fullbright)
"nl" = (
/obj/structure/flora/bush/grassy/style_4,
/turf/open/misc/grass/jungle,
/area/deathmatch/fullbright)
"nS" = (
/obj/structure/flora/bush/grassy,
/turf/open/floor/grass,
/area/deathmatch/fullbright)
"on" = (
/obj/structure/flora/tree/jungle/small/style_5,
/turf/open/floor/grass,
/area/deathmatch/fullbright)
"oC" = (
/obj/structure/flora/bush/leafy,
/obj/item/grown/log/bamboo,
/turf/open/misc/beach/sand,
/area/deathmatch/fullbright)
"pF" = (
/turf/open/misc/beach/sand,
/area/deathmatch/fullbright)
"qJ" = (
/obj/structure/flora/bush/jungle/b/style_2,
/turf/open/misc/grass/jungle,
/area/deathmatch/fullbright)
"rB" = (
/obj/structure/flora/grass/jungle/a/style_random,
/turf/open/floor/grass,
/area/deathmatch/fullbright)
"rO" = (
/obj/structure/flora/ash/seraka,
/turf/open/misc/dirt/jungle/wasteland,
/area/deathmatch/fullbright)
"sa" = (
/obj/structure/flora/tree/jungle/small/style_random,
/turf/open/misc/grass/jungle,
/area/deathmatch/fullbright)
"sP" = (
/obj/structure/flora/bush/lavendergrass/style_4,
/turf/open/misc/dirt/jungle,
/area/deathmatch/fullbright)
"uE" = (
/obj/structure/flora/bush/grassy/style_4,
/turf/open/floor/grass,
/area/deathmatch/fullbright)
"vy" = (
/obj/structure/flora/bush/grassy/style_2,
/turf/open/misc/grass/jungle,
/area/deathmatch/fullbright)
"vz" = (
/obj/structure/flora/bush/jungle/b/style_2,
/obj/effect/landmark/deathmatch_player_spawn,
/turf/open/misc/grass/jungle,
/area/deathmatch/fullbright)
"xb" = (
/obj/structure/flora/rock/pile/jungle,
/turf/open/misc/grass/jungle,
/turf/open/floor/grass,
/area/deathmatch/fullbright)
"xm" = (
/mob/living/basic/gorilla,
/obj/structure/window/spawner/directional/west,
/obj/structure/window/spawner/directional/north,
/turf/open/floor/grass,
/area/deathmatch/fullbright)
"xV" = (
/obj/structure/flora/bush/jungle/b/style_3,
/turf/open/misc/grass/jungle,
/area/deathmatch/fullbright)
"yn" = (
/obj/structure/flora/tree/jungle/style_6,
/turf/open/misc/grass/jungle,
/area/deathmatch/fullbright)
"yw" = (
/obj/structure/flora/rock/pile/jungle/large,
/turf/open/misc/grass/jungle,
/area/deathmatch/fullbright)
"yS" = (
/obj/structure/reagent_dispensers/water_cooler,
/turf/open/floor/wood,
/area/deathmatch/fullbright)
"zg" = (
/obj/item/clothing/head/utility/hardhat,
/turf/open/floor/grass,
/area/deathmatch/fullbright)
"zr" = (
/obj/structure/flora/bush/lavendergrass/style_4,
/turf/open/misc/beach/sand,
/area/deathmatch/fullbright)
"At" = (
/obj/structure/flora/rock/pile/jungle,
/obj/structure/flora/rock/style_4,
/turf/open/floor/holofloor/beach/water,
/area/deathmatch/fullbright)
"AT" = (
/obj/structure/flora/bush/jungle/b/style_3,
/turf/open/floor/grass,
/area/deathmatch/fullbright)
"BI" = (
/obj/effect/landmark/deathmatch_player_spawn,
/turf/open/misc/dirt/jungle/wasteland,
/area/deathmatch/fullbright)
"Ca" = (
/obj/item/clothing/head/costume/football_helmet,
/turf/open/floor/grass,
/area/deathmatch/fullbright)
"Cu" = (
/obj/item/spear/bamboospear,
/turf/open/floor/holofloor/beach/water,
/area/deathmatch/fullbright)
"Cv" = (
/obj/structure/flora/rock/style_4,
/turf/open/misc/dirt/jungle/wasteland,
/area/deathmatch/fullbright)
"Dn" = (
/obj/item/fireaxe/boneaxe,
/turf/open/misc/dirt/jungle,
/area/deathmatch/fullbright)
"Dp" = (
/obj/structure/table/wood/fancy/green,
/obj/structure/table/wood/fancy/green,
/obj/item/reagent_containers/cup/soda_cans/monkey_energy,
/obj/item/reagent_containers/cup/soda_cans/monkey_energy,
/turf/open/floor/vault/rock,
/area/deathmatch/fullbright)
"Dq" = (
/obj/item/food/grown/banana/bluespace,
/turf/open/floor/grass,
/area/deathmatch/fullbright)
"Dx" = (
/obj/structure/flora/grass/jungle/a/style_random,
/turf/open/misc/grass/jungle,
/area/deathmatch/fullbright)
"EP" = (
/obj/structure/flora/rock/pile/jungle/style_2,
/turf/open/floor/holofloor/beach/water,
/area/deathmatch/fullbright)
"FZ" = (
/obj/structure/flora/grass/jungle/a/style_2,
/turf/open/misc/grass/jungle,
/area/deathmatch/fullbright)
"Gb" = (
/obj/structure/flora/rock/pile/jungle,
/turf/open/misc/grass/jungle,
/area/deathmatch/fullbright)
"Ge" = (
/obj/structure/flora/grass/jungle/b/style_5,
/obj/item/food/grown/banana,
/turf/open/misc/grass/jungle,
/area/deathmatch/fullbright)
"Gw" = (
/obj/structure/flora/tree/jungle,
/turf/open/misc/grass/jungle,
/area/deathmatch/fullbright)
"GF" = (
/obj/item/melee/baseball_bat,
/turf/open/floor/grass,
/area/deathmatch/fullbright)
"GM" = (
/obj/item/food/grown/banana/bunch,
/turf/open/floor/grass,
/area/deathmatch/fullbright)
"Hf" = (
/turf/closed/indestructible/wood,
/area/deathmatch/fullbright)
"HF" = (
/obj/structure/punji_sticks/spikes,
/turf/open/floor/holofloor/beach/water,
/area/deathmatch/fullbright)
"HU" = (
/obj/structure/flora/tree/jungle/small,
/turf/open/floor/grass,
/area/deathmatch/fullbright)
"IG" = (
/obj/structure/punji_sticks,
/turf/open/floor/holofloor/beach/water,
/area/deathmatch/fullbright)
"Jn" = (
/obj/structure/flora/tree/jungle/style_4,
/turf/open/misc/grass/jungle,
/area/deathmatch/fullbright)
"JM" = (
/turf/open/floor/grass,
/area/deathmatch/fullbright)
"JO" = (
/obj/structure/flora/rock/pile/jungle/large,
/turf/open/misc/dirt/jungle/wasteland,
/area/deathmatch/fullbright)
"Kv" = (
/obj/structure/closet/mini_fridge/grimy,
/obj/structure/closet/mini_fridge/grimy,
/obj/item/reagent_containers/cup/soda_cans/monkey_energy,
/turf/open/floor/wood,
/area/deathmatch/fullbright)
"KC" = (
/obj/item/storage/box/gorillacubes,
/turf/open/floor/wood,
/area/deathmatch/fullbright)
"KD" = (
/turf/open/floor/wood,
/area/deathmatch/fullbright)
"LA" = (
/obj/structure/flora/rock/style_2,
/turf/open/misc/dirt/jungle/wasteland,
/area/deathmatch/fullbright)
"LC" = (
/obj/item/crowbar/hammer,
/turf/open/floor/grass,
/area/deathmatch/fullbright)
"Ng" = (
/obj/structure/table/wood/fancy/green,
/obj/item/reagent_containers/cup/soda_cans/monkey_energy,
/turf/open/floor/vault/rock,
/area/deathmatch/fullbright)
"NC" = (
/obj/structure/flora/rock/pile/jungle,
/turf/open/misc/dirt/jungle/wasteland,
/area/deathmatch/fullbright)
"NK" = (
/turf/open/space/basic,
/area/space)
"NW" = (
/obj/structure/flora/bush/jungle/b,
/turf/open/misc/grass/jungle,
/area/deathmatch/fullbright)
"OD" = (
/turf/closed/indestructible/fakeglass,
/area/deathmatch/fullbright)
"OT" = (
/obj/structure/headpike/bamboo,
/turf/open/floor/holofloor/beach/water,
/area/deathmatch/fullbright)
"OX" = (
/obj/structure/flora/tree/jungle/style_3,
/turf/open/misc/grass/jungle,
/area/deathmatch/fullbright)
"QJ" = (
/obj/structure/table/wood/fancy/orange,
/obj/item/food/grown/banana/bunch,
/turf/open/floor/wood,
/area/deathmatch/fullbright)
"QQ" = (
/obj/structure/flora/tree/jungle/style_2,
/turf/open/misc/grass/jungle,
/area/deathmatch/fullbright)
"SB" = (
/turf/open/misc/grass/jungle,
/area/deathmatch/fullbright)
"SI" = (
/obj/structure/punji_sticks,
/obj/item/spear/bamboospear,
/turf/open/floor/holofloor/beach/water,
/area/deathmatch/fullbright)
"SL" = (
/obj/structure/flora/grass/jungle/b,
/turf/open/misc/grass/jungle,
/area/deathmatch/fullbright)
"SM" = (
/obj/structure/flora/rock/pile/jungle,
/obj/item/food/grown/banana,
/turf/open/misc/grass/jungle,
/area/deathmatch/fullbright)
"Up" = (
/obj/structure/flora/rock/pile/jungle,
/obj/item/spear/bonespear,
/turf/open/misc/dirt/jungle,
/area/deathmatch/fullbright)
"UA" = (
/obj/structure/flora/tree/jungle/small/style_4,
/turf/open/floor/grass,
/area/deathmatch/fullbright)
"UB" = (
/obj/structure/flora/rock/pile/jungle,
/turf/open/floor/holofloor/beach/water,
/area/deathmatch/fullbright)
"UQ" = (
/obj/structure/flora/rock/pile/style_2,
/turf/open/misc/dirt/jungle/wasteland,
/area/deathmatch/fullbright)
"Vc" = (
/obj/structure/flora/bush/grassy,
/obj/effect/landmark/deathmatch_player_spawn,
/turf/open/floor/grass,
/area/deathmatch/fullbright)
"Vl" = (
/obj/structure/flora/rock/pile/style_3,
/turf/open/misc/dirt/jungle,
/area/deathmatch/fullbright)
"XO" = (
/obj/structure/flora/grass/jungle/b/style_5,
/turf/open/misc/grass/jungle,
/area/deathmatch/fullbright)
"YA" = (
/mob/living/basic/gorilla,
/obj/structure/window/spawner/directional/east,
/obj/structure/window/spawner/directional/north,
/turf/open/floor/grass,
/area/deathmatch/fullbright)
"YG" = (
/mob/living/carbon/human/species/monkey,
/turf/open/floor/wood,
/area/deathmatch/fullbright)
"YZ" = (
/turf/open/misc/dirt/jungle/wasteland,
/area/deathmatch/fullbright)
"ZG" = (
/obj/structure/flora/rock,
/obj/item/spear/bamboospear,
/turf/open/floor/holofloor/beach/water,
/area/deathmatch/fullbright)
"ZM" = (
/obj/structure/flora/grass/jungle/b/style_random,
/obj/structure/flora/grass/jungle/a/style_2,
/turf/open/misc/grass/jungle,
/area/deathmatch/fullbright)
"ZT" = (
/mob/living/basic/gorilla,
/obj/structure/window/spawner/directional/south,
/obj/structure/window/spawner/directional/east,
/turf/open/floor/grass,
/area/deathmatch/fullbright)

(1,1,1) = {"
NK
NK
NK
NK
NK
NK
NK
NK
NK
NK
NK
NK
NK
NK
NK
NK
NK
NK
NK
NK
NK
NK
NK
NK
NK
NK
NK
NK
NK
NK
NK
NK
NK
NK
NK
NK
NK
NK
NK
NK
NK
NK
NK
NK
NK
NK
NK
NK
"}
(2,1,1) = {"
NK
NK
NK
NK
NK
NK
NK
NK
NK
NK
NK
NK
NK
NK
NK
NK
NK
NK
NK
NK
NK
NK
NK
NK
NK
NK
NK
NK
NK
NK
NK
NK
NK
NK
NK
NK
NK
NK
NK
NK
NK
NK
NK
NK
NK
NK
NK
NK
"}
(3,1,1) = {"
NK
NK
NK
NK
NK
NK
NK
NK
NK
NK
NK
NK
NK
NK
NK
NK
NK
NK
NK
NK
NK
NK
NK
NK
NK
NK
NK
NK
NK
NK
NK
NK
NK
NK
NK
NK
NK
NK
NK
NK
NK
NK
NK
NK
NK
NK
NK
NK
"}
(4,1,1) = {"
NK
NK
NK
NK
NK
NK
NK
NK
NK
NK
NK
NK
NK
NK
NK
NK
NK
NK
NK
NK
NK
NK
NK
NK
NK
NK
NK
NK
NK
NK
NK
NK
NK
NK
NK
NK
NK
NK
NK
NK
NK
NK
NK
NK
NK
NK
NK
NK
"}
(5,1,1) = {"
NK
NK
NK
NK
NK
NK
NK
NK
NK
NK
NK
NK
NK
NK
NK
NK
NK
NK
NK
NK
NK
NK
NK
NK
NK
NK
NK
NK
NK
NK
NK
NK
NK
NK
NK
NK
NK
NK
NK
NK
NK
NK
NK
NK
NK
NK
NK
NK
"}
(6,1,1) = {"
NK
NK
NK
NK
NK
NK
NK
NK
NK
NK
NK
NK
NK
NK
NK
NK
NK
NK
NK
NK
NK
NK
NK
NK
NK
NK
NK
NK
NK
NK
NK
NK
NK
NK
NK
NK
NK
NK
NK
NK
NK
NK
NK
NK
NK
NK
NK
NK
"}
(7,1,1) = {"
NK
NK
NK
NK
NK
NK
NK
NK
NK
NK
NK
NK
NK
NK
NK
NK
NK
NK
NK
NK
NK
NK
Hf
Hf
Hf
Hf
Hf
NK
NK
NK
NK
NK
NK
NK
NK
NK
NK
NK
NK
NK
NK
NK
NK
NK
NK
NK
NK
NK
"}
(8,1,1) = {"
NK
NK
NK
NK
NK
NK
NK
NK
NK
NK
NK
NK
NK
NK
NK
NK
NK
NK
NK
NK
NK
NK
Hf
cw
cw
cw
Hf
NK
NK
NK
NK
NK
NK
NK
NK
NK
NK
NK
NK
NK
NK
NK
NK
NK
NK
NK
NK
NK
"}
(9,1,1) = {"
NK
NK
NK
NK
NK
NK
NK
NK
NK
NK
NK
NK
NK
NK
NK
NK
NK
NK
NK
NK
NK
NK
Hf
QJ
YG
QJ
Hf
NK
NK
NK
NK
NK
NK
NK
NK
NK
NK
NK
NK
NK
NK
NK
NK
NK
NK
NK
NK
NK
"}
(10,1,1) = {"
NK
NK
NK
NK
NK
NK
NK
NK
NK
NK
NK
NK
NK
NK
NK
NK
NK
NK
NK
NK
NK
NK
Hf
KC
KD
yS
Hf
NK
NK
NK
NK
NK
NK
NK
NK
NK
NK
NK
NK
NK
NK
NK
NK
NK
NK
NK
NK
NK
"}
(11,1,1) = {"
NK
NK
NK
NK
NK
NK
NK
NK
NK
NK
NK
NK
OD
OD
OD
OD
OD
OD
OD
OD
OD
OD
OD
Ng
Ng
Ng
OD
OD
OD
OD
OD
OD
OD
OD
OD
OD
OD
NK
NK
NK
NK
NK
NK
NK
NK
NK
NK
NK
"}
(12,1,1) = {"
NK
NK
NK
NK
NK
NK
NK
NK
NK
NK
NK
NK
OD
ZT
Ca
JM
JM
JM
JM
JM
JM
JM
JM
JM
ai
JM
JM
JM
HU
my
JM
JM
JM
JM
zg
YA
OD
NK
NK
NK
NK
NK
NK
NK
NK
NK
NK
NK
"}
(13,1,1) = {"
NK
NK
NK
NK
NK
NK
NK
NK
NK
NK
NK
NK
OD
GM
GF
JM
JM
Dq
JM
JM
JM
JM
JM
JM
AT
qJ
AT
JM
JM
JM
JM
JM
JM
UA
LC
GM
OD
NK
NK
NK
NK
NK
NK
NK
NK
NK
NK
NK
"}
(14,1,1) = {"
NK
NK
NK
NK
NK
NK
NK
NK
NK
NK
NK
NK
OD
JM
JM
JM
JM
JM
JM
JM
JM
JM
JM
rB
JM
sa
SB
JM
JM
JM
JM
JM
JM
JM
AT
dX
OD
NK
NK
NK
NK
NK
NK
NK
NK
NK
NK
NK
"}
(15,1,1) = {"
NK
NK
NK
NK
NK
NK
NK
NK
NK
NK
NK
NK
OD
JM
xV
my
nS
JM
JM
Gb
bu
iY
JM
dX
AT
JM
JM
JM
JM
aN
SB
bu
FZ
rB
rB
JM
OD
NK
NK
NK
NK
NK
NK
NK
NK
NK
NK
NK
"}
(16,1,1) = {"
NK
NK
NK
NK
NK
NK
NK
NK
NK
NK
NK
NK
OD
JM
Gw
vy
JM
JM
JM
SB
SB
bu
JM
JM
JM
JM
JM
JM
iY
yn
SB
Gb
bu
nS
JM
qJ
OD
NK
NK
NK
NK
NK
NK
NK
NK
NK
NK
NK
"}
(17,1,1) = {"
NK
NK
NK
NK
NK
NK
NK
NK
NK
NK
NK
NK
OD
JM
qJ
dX
rB
JM
XO
SB
lI
SB
SB
JM
Vc
JM
JM
JM
qJ
SM
pF
pF
XO
SB
Gw
xV
OD
NK
NK
NK
NK
NK
NK
NK
NK
NK
NK
NK
"}
(18,1,1) = {"
NK
NK
NK
NK
NK
NK
NK
NK
NK
NK
NK
NK
OD
JM
uE
JM
JM
JM
bu
SB
lI
OX
SB
SB
JM
JM
JM
nS
SB
NW
pF
pF
Gb
SB
JM
JM
OD
NK
NK
NK
NK
NK
NK
NK
NK
NK
NK
NK
"}
(19,1,1) = {"
NK
NK
NK
NK
NK
NK
NK
NK
NK
NK
NK
NK
OD
JM
JM
uE
JM
Gw
Gb
lI
hQ
qJ
nh
nl
JM
JM
JM
SL
iY
vz
pF
pF
yw
SB
uE
JM
OD
NK
NK
NK
NK
NK
NK
NK
NK
NK
NK
NK
"}
(20,1,1) = {"
NK
NK
NK
NK
NK
NK
NK
NK
NK
NK
NK
NK
OD
JM
nS
JM
SB
SB
qJ
lI
lI
yw
SB
XO
SB
SB
SB
bu
NW
pF
pF
pF
NW
qJ
SB
JM
OD
NK
NK
NK
NK
NK
NK
NK
NK
NK
NK
NK
"}
(21,1,1) = {"
NK
NK
NK
NK
NK
NK
NK
NK
NK
NK
NK
NK
OD
JM
JM
JM
XO
yw
lI
Vl
lI
lI
mY
qJ
SB
yw
SB
Gb
NW
ha
pF
pF
pF
qJ
SB
JM
OD
NK
NK
NK
NK
NK
NK
NK
NK
NK
NK
NK
"}
(22,1,1) = {"
NK
NK
NK
NK
NK
NK
NK
NK
Hf
Hf
Hf
Hf
OD
JM
JM
SB
SB
qJ
lI
lI
gS
lI
lI
Vl
sP
lI
pF
pF
pF
pF
pF
pF
pF
SB
aN
JM
OD
Hf
Hf
Hf
Hf
NK
NK
NK
NK
NK
NK
NK
"}
(23,1,1) = {"
NK
NK
NK
NK
NK
NK
NK
NK
Hf
cw
QJ
yS
Ng
JM
JM
qJ
Jn
NW
lI
lI
Vl
sP
lI
Dn
Up
pF
pF
pF
pF
pF
pF
pF
pF
qJ
QQ
JM
Ng
yS
QJ
cw
Hf
NK
NK
NK
NK
NK
NK
NK
"}
(24,1,1) = {"
NK
NK
NK
NK
NK
NK
NK
NK
Hf
cw
YG
KD
Dp
ai
JM
SB
SB
SB
BI
YZ
YZ
YZ
NC
dk
bZ
ZG
HF
zr
pF
pF
kr
pF
pF
SB
nh
ai
Ng
KD
YG
cw
Hf
NK
NK
NK
NK
NK
NK
NK
"}
(25,1,1) = {"
NK
NK
NK
NK
NK
NK
NK
NK
Hf
cw
QJ
KC
Ng
JM
JM
bu
xb
SB
YZ
YZ
YZ
JO
dO
IG
Cu
SI
dO
OT
HF
pF
pF
ha
qJ
SB
bu
JM
Ng
KC
QJ
cw
Hf
NK
NK
NK
NK
NK
NK
NK
"}
(26,1,1) = {"
NK
NK
NK
NK
NK
NK
NK
NK
Hf
Hf
Hf
Hf
OD
JM
JM
XO
aN
SB
YZ
UQ
YZ
ae
EP
dO
OT
UB
dO
dO
dO
oC
pF
pF
NW
SB
Gb
JM
OD
Hf
Hf
Hf
Hf
NK
NK
NK
NK
NK
NK
NK
"}
(27,1,1) = {"
NK
NK
NK
NK
NK
NK
NK
NK
NK
NK
NK
NK
OD
JM
JM
bu
yw
SB
YZ
YZ
YZ
rO
NC
dO
dO
dO
dO
dO
dO
EP
LA
YZ
yw
SB
JM
JM
OD
NK
NK
NK
NK
NK
NK
NK
NK
NK
NK
NK
"}
(28,1,1) = {"
NK
NK
NK
NK
NK
NK
NK
NK
NK
NK
NK
NK
OD
JM
nS
SB
SB
qJ
Gb
YZ
YZ
YZ
Cv
UB
dO
dO
dO
dO
dO
At
YZ
YZ
SB
SB
JM
JM
OD
NK
NK
NK
NK
NK
NK
NK
NK
NK
NK
NK
"}
(29,1,1) = {"
NK
NK
NK
NK
NK
NK
NK
NK
NK
NK
NK
NK
OD
JM
JM
JM
SB
SB
SB
SB
BI
YZ
ae
YZ
EP
dO
dO
EP
NC
BI
YZ
YZ
jL
SB
on
JM
OD
NK
NK
NK
NK
NK
NK
NK
NK
NK
NK
NK
"}
(30,1,1) = {"
NK
NK
NK
NK
NK
NK
NK
NK
NK
NK
NK
NK
OD
JM
dn
uE
qJ
SB
yn
SB
SB
YZ
LA
YZ
YZ
YZ
JO
ae
rO
YZ
YZ
YZ
aN
SB
iO
JM
OD
NK
NK
NK
NK
NK
NK
NK
NK
NK
NK
NK
"}
(31,1,1) = {"
NK
NK
NK
NK
NK
NK
NK
NK
NK
NK
NK
NK
OD
JM
JM
JM
nS
JM
Ge
qJ
SB
UQ
YZ
YZ
BI
YZ
YZ
YZ
YZ
YZ
NW
qJ
Jn
Gb
JM
JM
OD
NK
NK
NK
NK
NK
NK
NK
NK
NK
NK
NK
"}
(32,1,1) = {"
NK
NK
NK
NK
NK
NK
NK
NK
NK
NK
NK
NK
OD
JM
my
JM
JM
uE
bu
NW
SB
SB
SB
SB
NW
qJ
SB
NW
Gb
aN
SB
SB
nS
uE
JM
JM
OD
NK
NK
NK
NK
NK
NK
NK
NK
NK
NK
NK
"}
(33,1,1) = {"
NK
NK
NK
NK
NK
NK
NK
NK
NK
NK
NK
NK
OD
JM
AT
NW
JM
nS
iY
iY
SB
SB
qJ
yw
SB
SB
SB
SB
OX
nh
nS
JM
JM
JM
JM
NW
OD
NK
NK
NK
NK
NK
NK
NK
NK
NK
NK
NK
"}
(34,1,1) = {"
NK
NK
NK
NK
NK
NK
NK
NK
NK
NK
NK
NK
OD
JM
JM
jo
Dx
JM
JM
JM
qJ
SB
OX
fK
SB
SB
JM
JM
JM
JM
JM
JM
JM
JM
Dx
xV
OD
NK
NK
NK
NK
NK
NK
NK
NK
NK
NK
NK
"}
(35,1,1) = {"
NK
NK
NK
NK
NK
NK
NK
NK
NK
NK
NK
NK
OD
JM
JM
SB
qJ
JM
JM
JM
JM
JM
Gb
cL
ZM
JM
JM
JM
JM
JM
dX
JM
JM
SB
Gw
Dx
OD
NK
NK
NK
NK
NK
NK
NK
NK
NK
NK
NK
"}
(36,1,1) = {"
NK
NK
NK
NK
NK
NK
NK
NK
NK
NK
NK
NK
OD
GM
LC
rB
JM
JM
on
JM
dX
JM
JM
JM
JM
JM
JM
JM
rB
AT
rB
JM
JM
JM
GF
GM
OD
NK
NK
NK
NK
NK
NK
NK
NK
NK
NK
NK
"}
(37,1,1) = {"
NK
NK
NK
NK
NK
NK
NK
NK
NK
NK
NK
NK
OD
gz
zg
JM
JM
JM
JM
AT
Dq
dX
JM
JM
ai
JM
JM
JM
JM
HU
my
AT
JM
JM
Ca
xm
OD
NK
NK
NK
NK
NK
NK
NK
NK
NK
NK
NK
"}
(38,1,1) = {"
NK
NK
NK
NK
NK
NK
NK
NK
NK
NK
NK
NK
OD
OD
OD
OD
OD
OD
OD
OD
OD
OD
OD
Ng
Ng
Ng
OD
OD
OD
OD
OD
OD
OD
OD
OD
OD
OD
NK
NK
NK
NK
NK
NK
NK
NK
NK
NK
NK
"}
(39,1,1) = {"
NK
NK
NK
NK
NK
NK
NK
NK
NK
NK
NK
NK
NK
NK
NK
NK
NK
NK
NK
NK
NK
NK
Hf
yS
KD
KC
Hf
NK
NK
NK
NK
NK
NK
NK
NK
NK
NK
NK
NK
NK
NK
NK
NK
NK
NK
NK
NK
NK
"}
(40,1,1) = {"
NK
NK
NK
NK
NK
NK
NK
NK
NK
NK
NK
NK
NK
NK
NK
NK
NK
NK
NK
NK
NK
NK
Hf
QJ
YG
QJ
Hf
NK
NK
NK
NK
NK
NK
NK
NK
NK
NK
NK
NK
NK
NK
NK
NK
NK
NK
NK
NK
NK
"}
(41,1,1) = {"
NK
NK
NK
NK
NK
NK
NK
NK
NK
NK
NK
NK
NK
NK
NK
NK
NK
NK
NK
NK
NK
NK
Hf
cw
Kv
cw
Hf
NK
NK
NK
NK
NK
NK
NK
NK
NK
NK
NK
NK
NK
NK
NK
NK
NK
NK
NK
NK
NK
"}
(42,1,1) = {"
NK
NK
NK
NK
NK
NK
NK
NK
NK
NK
NK
NK
NK
NK
NK
NK
NK
NK
NK
NK
NK
NK
Hf
Hf
Hf
Hf
Hf
NK
NK
NK
NK
NK
NK
NK
NK
NK
NK
NK
NK
NK
NK
NK
NK
NK
NK
NK
NK
NK
"}
(43,1,1) = {"
NK
NK
NK
NK
NK
NK
NK
NK
NK
NK
NK
NK
NK
NK
NK
NK
NK
NK
NK
NK
NK
NK
NK
NK
NK
NK
NK
NK
NK
NK
NK
NK
NK
NK
NK
NK
NK
NK
NK
NK
NK
NK
NK
NK
NK
NK
NK
NK
"}
(44,1,1) = {"
NK
NK
NK
NK
NK
NK
NK
NK
NK
NK
NK
NK
NK
NK
NK
NK
NK
NK
NK
NK
NK
NK
NK
NK
NK
NK
NK
NK
NK
NK
NK
NK
NK
NK
NK
NK
NK
NK
NK
NK
NK
NK
NK
NK
NK
NK
NK
NK
"}
(45,1,1) = {"
NK
NK
NK
NK
NK
NK
NK
NK
NK
NK
NK
NK
NK
NK
NK
NK
NK
NK
NK
NK
NK
NK
NK
NK
NK
NK
NK
NK
NK
NK
NK
NK
NK
NK
NK
NK
NK
NK
NK
NK
NK
NK
NK
NK
NK
NK
NK
NK
"}
(46,1,1) = {"
NK
NK
NK
NK
NK
NK
NK
NK
NK
NK
NK
NK
NK
NK
NK
NK
NK
NK
NK
NK
NK
NK
NK
NK
NK
NK
NK
NK
NK
NK
NK
NK
NK
NK
NK
NK
NK
NK
NK
NK
NK
NK
NK
NK
NK
NK
NK
NK
"}
(47,1,1) = {"
NK
NK
NK
NK
NK
NK
NK
NK
NK
NK
NK
NK
NK
NK
NK
NK
NK
NK
NK
NK
NK
NK
NK
NK
NK
NK
NK
NK
NK
NK
NK
NK
NK
NK
NK
NK
NK
NK
NK
NK
NK
NK
NK
NK
NK
NK
NK
NK
"}
