//MAP CONVERTED BY dmm2tgm.py THIS HEADER COMMENT PREVENTS RECONVERSION, DO NOT REMOVE
"a" = (
/turf/closed/mineral/volcanic/lava_land_surface,
/area/lavaland/surface/outdoors)
"c" = (
/obj/effect/decal/remains/human,
/turf/closed/mineral/volcanic/lava_land_surface,
/area/lavaland/surface/outdoors)
"h" = (
/turf/open/misc/ashplanet/wateryrock{
	slowdown = 0
	},
/area/lavaland/surface/outdoors)
"Q" = (
/obj/effect/decal/remains/human,
/turf/open/misc/ashplanet/wateryrock{
	slowdown = 0
	},
/area/lavaland/surface/outdoors)
"X" = (
/mob/living/basic/exiled_king,
/turf/open/misc/ashplanet/wateryrock{
	slowdown = 0
	},
/area/lavaland/surface/outdoors)

(1,1,1) = {"
a
a
a
a
a
a
a
a
a
a
a
a
a
a
a
a
a
a
a
a
"}
(2,1,1) = {"
a
a
a
a
a
a
a
c
a
a
a
a
a
a
a
a
a
a
a
a
"}
(3,1,1) = {"
a
a
h
h
h
h
h
h
h
h
h
h
h
h
h
h
h
h
a
a
"}
(4,1,1) = {"
a
a
h
h
h
h
h
h
h
h
h
h
h
h
h
h
h
h
a
a
"}
(5,1,1) = {"
a
a
h
h
h
h
h
h
h
h
h
h
h
h
h
h
h
h
a
a
"}
(6,1,1) = {"
a
a
h
h
h
h
h
h
h
h
h
h
h
h
h
h
h
h
a
a
"}
(7,1,1) = {"
a
a
h
h
h
h
h
Q
h
h
Q
h
h
h
Q
h
h
h
a
a
"}
(8,1,1) = {"
a
a
h
h
h
h
h
h
h
h
h
h
h
h
h
h
h
h
a
a
"}
(9,1,1) = {"
a
a
h
h
Q
h
h
h
h
h
h
h
h
h
h
h
h
h
a
a
"}
(10,1,1) = {"
a
a
h
h
h
h
h
Q
h
h
X
h
h
h
h
h
Q
h
a
a
"}
(11,1,1) = {"
a
a
h
h
h
h
h
h
h
h
h
h
h
Q
h
h
h
h
a
a
"}
(12,1,1) = {"
c
a
h
h
h
h
Q
h
Q
h
h
h
h
h
h
h
h
h
a
a
"}
(13,1,1) = {"
a
a
Q
Q
h
Q
Q
h
h
h
h
h
h
h
h
h
h
h
c
a
"}
(14,1,1) = {"
c
a
h
h
h
h
h
h
h
h
h
h
Q
h
h
h
h
h
a
a
"}
(15,1,1) = {"
a
a
h
h
h
h
h
Q
h
h
Q
h
h
h
h
h
h
h
a
a
"}
(16,1,1) = {"
a
a
h
h
h
h
h
h
h
h
h
h
h
h
h
h
h
h
a
a
"}
(17,1,1) = {"
c
a
h
h
h
h
Q
Q
h
h
h
h
h
h
h
h
h
h
a
a
"}
(18,1,1) = {"
a
a
h
h
h
h
h
Q
h
h
h
h
h
h
h
h
h
Q
a
a
"}
(19,1,1) = {"
a
c
a
c
c
a
c
a
a
a
a
a
a
a
a
a
a
a
a
a
"}
(20,1,1) = {"
a
a
c
a
a
a
a
a
a
a
a
a
a
a
a
a
a
a
a
a
"}
