//MAP CONVERTED BY dmm2tgm.py THIS HEADER COMMENT PREVENTS RECONVERSION, DO NOT REMOVE
"ab" = (
/turf/open/space/basic,
/area/space)
"ah" = (
/obj/item/flashlight/lantern{
	light_on = 1;
	pixel_x = 10;
	pixel_y = 10
	},
/obj/structure/flora/bush/flowers_br/style_2,
/turf/open/misc/grass/jungle,
/area/ruin/space/has_grav/wonderland)
"av" = (
/obj/structure/chair/wood{
	dir = 4
	},
/obj/item/toy/plush/goatplushie,
/turf/open/misc/grass/jungle,
/area/ruin/space/has_grav/wonderland)
"aB" = (
/obj/item/flashlight/lantern{
	light_on = 1;
	pixel_x = 15;
	pixel_y = -20
	},
/turf/open/misc/snow/actually_safe,
/area/ruin/space/has_grav/wonderland)
"aR" = (
/obj/item/clothing/shoes/costume_2021/doll_shoes,
/turf/open/misc/grass/jungle,
/area/ruin/space/has_grav/wonderland)
"bf" = (
/obj/structure/chess/blackrook,
/turf/open/floor/holofloor/pure_white,
/area/ruin/space/has_grav/wonderchess)
"br" = (
/obj/structure/chess/blackknight,
/turf/open/floor/black,
/area/ruin/space/has_grav/wonderchess)
"bM" = (
/obj/structure/flora/bush/flowers_br/style_2,
/mob/living/basic/rabbit,
/turf/open/misc/grass/jungle,
/area/ruin/space/has_grav/wonderland)
"bV" = (
/obj/item/flashlight/lantern{
	light_on = 1;
	pixel_x = 17;
	pixel_y = 24
	},
/turf/open/misc/grass/jungle,
/area/ruin/space/has_grav/wonderland)
"bZ" = (
/obj/item/clothing/head/costume_2021/doll_hat,
/turf/open/misc/grass/jungle,
/area/ruin/space/has_grav/wonderland)
"cg" = (
/obj/structure/flora/tree/jungle/style_3,
/turf/open/misc/grass/jungle,
/area/ruin/space/has_grav/wonderland)
"cj" = (
/obj/structure/chess/blackbishop,
/turf/open/floor/holofloor/pure_white,
/area/ruin/space/has_grav/wonderchess)
"cs" = (
/obj/structure/bed{
	dir = 1
	},
/obj/item/bedsheet/purple{
	dir = 1
	},
/turf/open/floor/wood/large,
/area/ruin/space/has_grav/wonderland)
"ct" = (
/obj/structure/chess/blackqueen,
/turf/open/floor/black,
/area/ruin/space/has_grav/wonderchess)
"cE" = (
/obj/item/flashlight/lantern{
	light_on = 1
	},
/obj/structure/flora/rock/pile/style_3,
/turf/open/misc/grass/jungle,
/area/ruin/space/has_grav/wonderland)
"cQ" = (
/obj/structure/chair/wood{
	dir = 4
	},
/turf/open/misc/grass/jungle,
/area/ruin/space/has_grav/wonderland)
"de" = (
/obj/structure/chess/whiterook,
/turf/open/floor/holofloor/pure_white,
/area/ruin/space/has_grav/wonderchess)
"dh" = (
/obj/structure/flora/tree/dead/style_4,
/obj/structure/flora/bush/flowers_pp/style_2,
/turf/open/misc/snow/actually_safe,
/area/ruin/space/has_grav/wonderland)
"di" = (
/turf/closed/indestructible/rock,
/area/ruin/space/has_grav/wonderland)
"dC" = (
/obj/effect/rune/narsie{
	used = 1
	},
/turf/open/floor/wood/large,
/area/ruin/space/has_grav/wonderland)
"dE" = (
/obj/structure/chess/blackking,
/turf/open/floor/holofloor/pure_white,
/area/ruin/space/has_grav/wonderchess)
"dJ" = (
/obj/structure/chess/blackbishop,
/turf/open/floor/black,
/area/ruin/space/has_grav/wonderchess)
"ed" = (
/obj/effect/decal/cleanable/blood/old,
/obj/effect/mob_spawn/corpse/rabbit,
/obj/item/food/grown/carrot,
/turf/open/floor/wood/large,
/area/ruin/space/has_grav/wonderland)
"eu" = (
/obj/structure/weaponsmith,
/turf/open/floor/wood/large,
/area/ruin/space/has_grav/wonderland)
"fb" = (
/obj/structure/chess/blackknight,
/turf/open/floor/holofloor/pure_white,
/area/ruin/space/has_grav/wonderchess)
"gc" = (
/obj/structure/blood_fountain,
/obj/structure/flora/bush/flowers_br/style_2,
/turf/open/misc/grass/jungle,
/area/ruin/space/has_grav/wonderland)
"gu" = (
/turf/open/floor/wood/large,
/area/ruin/space/has_grav/wonderchess)
"gw" = (
/obj/structure/chess/blackrook,
/turf/open/floor/black,
/area/ruin/space/has_grav/wonderchess)
"gP" = (
/turf/closed/indestructible/wood,
/area/ruin/space/has_grav/wonderchess)
"hK" = (
/obj/item/flashlight/lantern{
	light_on = 1;
	pixel_x = -10;
	pixel_y = -4
	},
/turf/open/floor/wood/large,
/area/ruin/space/has_grav/wonderland)
"jT" = (
/obj/structure/chess/whiteking,
/turf/open/floor/black,
/area/ruin/space/has_grav/wonderchess)
"kh" = (
/obj/item/flashlight/lantern{
	light_on = 1;
	pixel_x = -5
	},
/turf/open/misc/grass/jungle,
/area/ruin/space/has_grav/wonderland)
"lg" = (
/obj/item/reagent_containers/cup/glass/mug,
/obj/structure/table/wood,
/obj/item/reagent_containers/cup/glass/mug{
	pixel_x = 7;
	pixel_y = 10
	},
/obj/item/reagent_containers/cup/glass/mug{
	pixel_x = -7;
	pixel_y = 10
	},
/turf/open/misc/grass/jungle,
/area/ruin/space/has_grav/wonderland)
"mD" = (
/obj/structure/chess,
/turf/open/floor/black,
/area/ruin/space/has_grav/wonderchess)
"mP" = (
/obj/structure/chess/blackpawn,
/turf/open/floor/black,
/area/ruin/space/has_grav/wonderchess)
"mS" = (
/obj/structure/flora/bush/flowers_yw,
/obj/structure/flora/bush/flowers_br/style_2,
/mob/living/basic/rabbit,
/turf/open/misc/grass/jungle,
/area/ruin/space/has_grav/wonderland)
"np" = (
/obj/item/flashlight/lantern{
	light_on = 1
	},
/obj/structure/flora/rock/pile,
/turf/open/misc/grass/jungle,
/area/ruin/space/has_grav/wonderland)
"nQ" = (
/obj/structure/flora/tree/dead/style_2,
/turf/open/misc/snow/actually_safe,
/area/ruin/space/has_grav/wonderland)
"oB" = (
/obj/structure/dresser,
/turf/open/floor/wood/large,
/area/ruin/space/has_grav/wonderland)
"oC" = (
/obj/structure/chair/wood,
/obj/item/clothing/head/collectable/tophat,
/turf/open/misc/grass/jungle,
/area/ruin/space/has_grav/wonderland)
"oF" = (
/turf/open/floor/black,
/area/ruin/space/has_grav/wonderchess)
"pe" = (
/obj/item/flashlight/lantern{
	light_on = 1
	},
/turf/open/floor/wood/large,
/area/ruin/space/has_grav/wonderchess)
"pN" = (
/obj/structure/chess/whiterook,
/turf/open/floor/black,
/area/ruin/space/has_grav/wonderchess)
"rr" = (
/obj/structure/flora/bush/flowers_yw,
/obj/structure/flora/bush/flowers_br/style_2,
/turf/open/misc/grass/jungle,
/area/ruin/space/has_grav/wonderland)
"rA" = (
/obj/item/flashlight/lantern{
	light_on = 1
	},
/obj/structure/flora/bush/flowers_br/style_2,
/turf/open/misc/grass/jungle,
/area/ruin/space/has_grav/wonderland)
"sr" = (
/obj/item/grenade/jack,
/obj/item/grenade/jack,
/obj/item/grenade/jack,
/obj/item/grenade/jack,
/obj/structure/closet/cabinet,
/turf/open/floor/wood/large,
/area/ruin/space/has_grav/wonderland)
"tb" = (
/obj/effect/decal/cleanable/blood/old,
/obj/effect/mob_spawn/corpse/rabbit,
/turf/open/floor/wood/large,
/area/ruin/space/has_grav/wonderland)
"tE" = (
/obj/structure/flora/tree/stump,
/turf/open/misc/grass/jungle,
/area/ruin/space/has_grav/wonderland)
"tS" = (
/obj/item/flashlight/lantern{
	light_on = 1
	},
/turf/open/misc/grass/jungle,
/area/ruin/space/has_grav/wonderland)
"wq" = (
/obj/item/flashlight/lantern{
	light_on = 1;
	pixel_x = 15
	},
/turf/open/misc/snow/actually_safe,
/area/ruin/space/has_grav/wonderland)
"wP" = (
/obj/item/flashlight/lantern{
	light_on = 1;
	pixel_x = 10;
	pixel_y = -4
	},
/turf/open/floor/wood/large,
/area/ruin/space/has_grav/wonderland)
"wY" = (
/mob/living/basic/rabbit,
/turf/open/misc/grass/jungle,
/area/ruin/space/has_grav/wonderland)
"yW" = (
/obj/item/clothing/under/costume_2021/doll_suit,
/obj/structure/flora/bush/flowers_pp/style_2,
/turf/open/misc/grass/jungle,
/area/ruin/space/has_grav/wonderland)
"Av" = (
/obj/structure/flora/bush/flowers_yw,
/mob/living/basic/rabbit,
/turf/open/misc/grass/jungle,
/area/ruin/space/has_grav/wonderland)
"AH" = (
/obj/structure/flora/bush/flowers_yw,
/turf/open/misc/grass/jungle,
/area/ruin/space/has_grav/wonderland)
"Bh" = (
/obj/structure/flora/tree/jungle/style_2,
/turf/open/misc/grass/jungle,
/area/ruin/space/has_grav/wonderland)
"BY" = (
/obj/structure/flora/rock/pile/style_random,
/turf/open/misc/grass/jungle,
/area/ruin/space/has_grav/wonderland)
"Ck" = (
/obj/structure/flora/bush/flowers_yw,
/obj/structure/flora/bush/flowers_br,
/turf/open/misc/grass/jungle,
/area/ruin/space/has_grav/wonderland)
"Cw" = (
/obj/structure/chess/whitebishop,
/turf/open/floor/holofloor/pure_white,
/area/ruin/space/has_grav/wonderchess)
"CP" = (
/obj/structure/flora/rock/icy,
/turf/open/misc/snow/actually_safe,
/area/ruin/space/has_grav/wonderland)
"Dh" = (
/turf/open/misc/snow/actually_safe,
/area/ruin/space/has_grav/wonderland)
"DE" = (
/obj/item/flashlight/lantern{
	light_on = 1
	},
/obj/structure/flora/rock/pile/icy,
/turf/open/misc/grass/jungle,
/area/ruin/space/has_grav/wonderland)
"DV" = (
/obj/structure/flora/rock/icy/style_2,
/turf/open/misc/snow/actually_safe,
/area/ruin/space/has_grav/wonderland)
"El" = (
/turf/open/floor/holofloor/pure_white,
/area/ruin/space/has_grav/wonderchess)
"Ev" = (
/obj/structure/flora/bush/flowers_pp/style_2,
/obj/structure/flora/tree/jungle/style_6,
/turf/open/misc/grass/jungle,
/area/ruin/space/has_grav/wonderland)
"Fd" = (
/turf/closed/indestructible/rock/snow,
/area/ruin/space/has_grav/wonderland)
"Ff" = (
/obj/structure/flora/bush/flowers_pp/style_2,
/obj/structure/flora/tree/jungle/style_4,
/turf/open/misc/grass/jungle,
/area/ruin/space/has_grav/wonderland)
"Fj" = (
/obj/structure/bonfire/prelit,
/turf/open/misc/snow/actually_safe,
/area/ruin/space/has_grav/wonderland)
"Fm" = (
/obj/structure/flora/bush/flowers_pp/style_2,
/turf/open/misc/snow/actually_safe,
/area/ruin/space/has_grav/wonderland)
"FO" = (
/obj/structure/flora/tree/jungle,
/turf/open/misc/grass/jungle,
/area/ruin/space/has_grav/wonderland)
"Ge" = (
/obj/structure/flora/rock/icy/style_3,
/turf/open/misc/snow/actually_safe,
/area/ruin/space/has_grav/wonderland)
"Gl" = (
/obj/structure/mineral_door/wood,
/turf/open/floor/wood/large,
/area/ruin/space/has_grav/wonderland)
"Gs" = (
/obj/structure/table/wood,
/obj/item/blood_vial,
/turf/open/floor/wood/large,
/area/ruin/space/has_grav/wonderland)
"Gx" = (
/obj/effect/mob_spawn/corpse/rabbit,
/obj/effect/decal/cleanable/blood/old,
/turf/open/floor/wood/large,
/area/ruin/space/has_grav/wonderland)
"HK" = (
/obj/effect/decal/cleanable/blood/old,
/turf/open/floor/wood/large,
/area/ruin/space/has_grav/wonderland)
"HR" = (
/obj/structure/chair/wood{
	dir = 8
	},
/obj/item/toy/plush/shark,
/turf/open/misc/grass/jungle,
/area/ruin/space/has_grav/wonderland)
"Iq" = (
/obj/structure/chess/whiteknight,
/turf/open/floor/holofloor/pure_white,
/area/ruin/space/has_grav/wonderchess)
"Jy" = (
/obj/structure/flora/tree/dead/style_6,
/turf/open/misc/snow/actually_safe,
/area/ruin/space/has_grav/wonderland)
"JP" = (
/obj/structure/chess/whitebishop,
/turf/open/floor/black,
/area/ruin/space/has_grav/wonderchess)
"JX" = (
/obj/structure/chess/blackpawn,
/turf/open/floor/holofloor/pure_white,
/area/ruin/space/has_grav/wonderchess)
"Kw" = (
/obj/structure/chess,
/turf/open/floor/holofloor/pure_white,
/area/ruin/space/has_grav/wonderchess)
"Mo" = (
/obj/structure/flora/tree/dead,
/turf/open/misc/snow/actually_safe,
/area/ruin/space/has_grav/wonderland)
"Mw" = (
/obj/structure/flora/bush/flowers_br/style_2,
/turf/open/misc/grass/jungle,
/area/ruin/space/has_grav/wonderland)
"NS" = (
/obj/structure/flora/rock/pile/style_2,
/turf/open/misc/grass/jungle,
/area/ruin/space/has_grav/wonderland)
"Od" = (
/obj/structure/statue/snow/snowman{
	pixel_x = -15;
	pixel_y = -15;
	anchored = 1;
	density = 0
	},
/turf/open/misc/snow/actually_safe,
/area/ruin/space/has_grav/wonderland)
"Oq" = (
/obj/item/flashlight/lantern{
	light_on = 1;
	pixel_x = 15
	},
/turf/open/misc/grass/jungle,
/area/ruin/space/has_grav/wonderland)
"OX" = (
/obj/structure/flora/rock/style_4{
	pixel_x = -5;
	pixel_y = -5
	},
/turf/open/misc/grass/jungle,
/area/ruin/space/has_grav/wonderland)
"PU" = (
/obj/structure/chess/redqueen,
/obj/effect/decal/cleanable/blood/bubblegum,
/turf/open/floor/holofloor/pure_white,
/area/ruin/space/has_grav/wonderchess)
"RW" = (
/obj/structure/flora/tree/jungle/style_6,
/obj/structure/flora/bush/flowers_pp/style_2,
/turf/open/misc/grass/jungle,
/area/ruin/space/has_grav/wonderland)
"Se" = (
/obj/structure/flora/bush/flowers_yw,
/obj/structure/flora/bush/flowers_pp,
/turf/open/misc/grass/jungle,
/area/ruin/space/has_grav/wonderland)
"Sy" = (
/turf/open/floor/wood/large,
/area/ruin/space/has_grav/wonderland)
"Tc" = (
/obj/structure/table/wood,
/obj/item/reagent_containers/cup/glass/mug{
	pixel_y = 10
	},
/obj/item/reagent_containers/cup/glass/mug{
	pixel_x = -7
	},
/obj/item/reagent_containers/cup/glass/mug{
	pixel_x = 7
	},
/obj/item/flashlight/lantern{
	light_on = 1;
	pixel_y = -5
	},
/turf/open/misc/grass/jungle,
/area/ruin/space/has_grav/wonderland)
"Ts" = (
/obj/structure/flora/rock/pile/icy/style_2,
/turf/open/misc/grass/jungle,
/area/ruin/space/has_grav/wonderland)
"TF" = (
/obj/structure/flora/tree/dead/style_5,
/turf/open/misc/snow/actually_safe,
/area/ruin/space/has_grav/wonderland)
"UO" = (
/obj/structure/flora/bush/flowers_yw,
/obj/structure/flora/bush/flowers_pp/style_2,
/turf/open/misc/grass/jungle,
/area/ruin/space/has_grav/wonderland)
"Vo" = (
/obj/structure/table/wood,
/turf/open/floor/wood/large,
/area/ruin/space/has_grav/wonderland)
"VG" = (
/obj/item/flashlight/lantern{
	light_on = 1;
	pixel_x = -15
	},
/turf/open/misc/snow/actually_safe,
/area/ruin/space/has_grav/wonderland)
"Wb" = (
/turf/open/misc/ashplanet/wateryrock{
	initial_gas_mix = "o2=22;n2=82;TEMP=293.15";
	planetary_atmos = 0;
	slowdown = 0
	},
/area/ruin/space/has_grav/wonderland)
"Wc" = (
/obj/structure/flora/bush/flowers_pp/style_2,
/obj/item/flashlight/lantern{
	light_on = 1
	},
/turf/open/misc/grass/jungle,
/area/ruin/space/has_grav/wonderland)
"WD" = (
/turf/closed/indestructible/wood,
/area/ruin/space/has_grav/wonderland)
"Xc" = (
/obj/item/flashlight/lantern{
	light_on = 1;
	pixel_x = 8;
	pixel_y = 15
	},
/turf/open/misc/snow/actually_safe,
/area/ruin/space/has_grav/wonderland)
"Xk" = (
/turf/open/water/beach,
/area/ruin/space/has_grav/wonderland)
"Xr" = (
/obj/structure/closet/crate/grave/filled,
/turf/open/misc/grass/jungle,
/area/ruin/space/has_grav/wonderland)
"Xt" = (
/obj/structure/chair/wood{
	dir = 1
	},
/obj/effect/landmark/wonderland_mark,
/turf/open/misc/grass/jungle,
/area/ruin/space/has_grav/wonderland)
"Xv" = (
/obj/structure/flora/bush/flowers_yw,
/obj/structure/flora/bush/flowers_br,
/mob/living/basic/rabbit,
/turf/open/misc/grass/jungle,
/area/ruin/space/has_grav/wonderland)
"XC" = (
/obj/structure/chair/wood{
	dir = 8
	},
/obj/item/toy/plush/goatplushie,
/turf/open/misc/grass/jungle,
/area/ruin/space/has_grav/wonderland)
"Yf" = (
/obj/effect/landmark/wonderchess_mark,
/turf/open/floor/black,
/area/ruin/space/has_grav/wonderchess)
"Yj" = (
/obj/structure/chess/whiteknight,
/turf/open/floor/black,
/area/ruin/space/has_grav/wonderchess)
"Yp" = (
/obj/structure/flora/bush/flowers_pp/style_2,
/turf/open/misc/grass/jungle,
/area/ruin/space/has_grav/wonderland)
"YP" = (
/obj/item/flashlight/lantern{
	light_on = 1;
	pixel_x = -15;
	pixel_y = 20
	},
/turf/open/misc/grass/jungle,
/area/ruin/space/has_grav/wonderland)
"ZA" = (
/turf/open/misc/grass/jungle,
/area/ruin/space/has_grav/wonderland)
"ZK" = (
/obj/structure/flora/rock/icy/style_2,
/turf/open/misc/grass/jungle,
/area/ruin/space/has_grav/wonderland)

(1,1,1) = {"
ab
ab
ab
ab
ab
ab
ab
ab
ab
ab
ab
ab
ab
ab
ab
ab
ab
ab
ab
ab
ab
ab
ab
ab
ab
ab
ab
ab
ab
ab
ab
ab
ab
ab
ab
ab
ab
ab
ab
ab
ab
ab
"}
(2,1,1) = {"
ab
ab
ab
ab
ab
ab
ab
ab
ab
ab
ab
ab
ab
ab
di
di
di
di
di
di
di
di
di
di
di
di
di
Fd
Fd
Fd
Fd
Fd
Fd
Fd
Fd
Fd
Fd
Fd
di
di
di
ab
"}
(3,1,1) = {"
ab
ab
ab
ab
ab
ab
ab
ab
ab
ab
ab
ab
ab
ab
di
ZA
ZA
ZA
ZA
wY
ZA
ZA
ZA
ZA
ZA
ZA
ZA
ZA
Dh
Dh
Dh
ZA
ZA
ZA
ZA
Dh
Dh
Dh
ZA
ZA
di
ab
"}
(4,1,1) = {"
ab
ab
ab
ab
ab
ab
ab
ab
ab
ab
ab
ab
ab
ab
di
ZA
ZA
ZA
Mw
ZA
wY
ZA
ZA
ZA
Ff
wY
Yp
ZA
ZA
nQ
Xc
ZA
ZA
ZA
ZA
ZA
ZA
ZA
ZA
ZA
di
ab
"}
(5,1,1) = {"
ab
ab
ab
ab
ab
ab
ab
ab
ab
ab
ab
ab
ab
ab
di
ZA
ZA
ZA
RW
ZA
ZA
ah
Yp
ZA
ZA
YP
ZA
ZA
ZA
ZA
ZA
ZA
OX
ZA
ZA
ZA
wq
ZA
ZA
ZA
Fd
ab
"}
(6,1,1) = {"
ab
ab
ab
ab
ab
ab
ab
ab
ab
ab
ab
ab
ab
ab
di
kh
ZA
ZA
ZA
ZA
ZA
Mw
ZA
ZA
wY
Yp
ZA
wY
Yp
ZA
ZA
ZA
ZA
ZA
ZA
Dh
TF
Dh
ZA
ZA
Fd
ab
"}
(7,1,1) = {"
ab
ab
ab
ab
ab
ab
ab
ab
ab
ab
ab
ab
ab
ab
di
Yp
ZA
ZA
ZA
bM
ZA
ZA
Mw
ZA
ZA
Yp
ZA
ZA
ZA
ZA
ZA
Dh
Fm
ZA
ZA
Dh
Dh
Dh
ZA
ZA
Fd
ab
"}
(8,1,1) = {"
ab
ab
ab
ab
ab
ab
ab
ab
ab
ab
ab
ab
ab
ab
WD
WD
WD
WD
WD
WD
WD
ZA
ZA
ZA
ZA
wY
ZA
cg
Yp
wY
ZA
Fm
Mo
Dh
ZA
ZA
ZA
ZA
ZA
ZA
di
ab
"}
(9,1,1) = {"
ab
ab
ab
ab
ab
ab
ab
ab
ab
ab
ab
ab
ab
ab
WD
oB
cs
Vo
Gs
Vo
WD
ZA
tE
ZA
Mw
ZA
ZA
ZA
ZA
ZA
ZA
ZA
VG
ZA
ZA
ZA
ZA
ZA
Dh
Dh
di
ab
"}
(10,1,1) = {"
ab
ab
ab
ab
ab
ab
ab
ab
ab
ab
ab
ab
ab
ab
WD
sr
HK
Gx
Sy
Vo
WD
ZA
ZA
ZA
rA
ZA
ZA
ZA
ZA
Yp
ZA
ZA
ZA
ZA
ZA
ZA
ZA
Dh
aB
DV
di
ab
"}
(11,1,1) = {"
ab
ab
ab
ab
ab
ab
ab
ab
ab
ab
ab
ab
ab
ab
WD
Sy
Sy
Gx
HK
hK
WD
ZA
ZA
ZA
ZA
ZA
Yp
ZA
ZA
ZA
ZA
Wb
Wb
Wb
Wb
Wb
Wb
Wb
Wb
CP
Fd
ab
"}
(12,1,1) = {"
ab
ab
ab
ab
ab
ab
ab
ab
ab
ab
ab
ab
ab
ab
WD
eu
Sy
dC
tb
Sy
Gl
ZA
ZA
ZA
Wb
Wb
Wb
Wb
np
Wb
Wb
Wb
Xk
Xk
Xk
Xk
Xk
Xk
Wb
Wb
Fd
ab
"}
(13,1,1) = {"
ab
ab
ab
ab
ab
ab
ab
ab
ab
ab
ab
ab
ab
ab
WD
Sy
HK
Sy
Sy
wP
WD
ZA
BY
gc
Wb
Xk
Xk
Wb
Wb
Wb
Xk
Xk
Xk
Xk
Xk
Xk
Xk
Xk
Xk
Xk
Fd
ab
"}
(14,1,1) = {"
ab
ab
ab
ab
ab
ab
ab
ab
ab
ab
ab
ab
ab
ab
WD
HK
ed
Sy
Sy
Vo
WD
ZA
NS
Mw
Wb
Xk
Xk
Xk
Xk
Xk
Xk
Xk
Xk
Wb
Wb
Wb
Wb
Xk
Xk
Xk
Fd
ab
"}
(15,1,1) = {"
ab
ab
ab
ab
ab
ab
ab
ab
ab
ab
ab
ab
ab
ab
WD
tb
HK
HK
Vo
Vo
WD
ZA
ZA
ZA
Wb
Wb
Xk
Xk
Xk
Xk
Xk
Wb
Wb
Wb
Ts
DE
Wb
Wb
Wb
Wb
Fd
ab
"}
(16,1,1) = {"
ab
ab
ab
ab
ab
ab
ab
ab
ab
ab
ab
ab
ab
ab
WD
WD
WD
WD
WD
WD
WD
ZA
ZA
ZA
cE
Wb
Wb
Wb
Wb
Wb
Wb
Wb
ZA
ZA
ZA
ZA
ZA
Dh
Dh
Ge
Fd
ab
"}
(17,1,1) = {"
ab
ab
ab
ab
ab
ab
ab
ab
ab
ab
ab
ab
ab
ab
di
rA
ZA
ZA
ZA
wY
ZA
ZA
Yp
ZA
ZA
ZA
ZA
ZA
ZA
ZA
Mw
ZA
ZA
ZA
ZA
ZA
ZA
ZA
Dh
Dh
Fd
ab
"}
(18,1,1) = {"
ab
ab
ab
ab
ab
ab
ab
ab
ab
ab
ab
ab
ab
ab
di
ZA
ZA
ZA
Bh
ZA
Yp
ZA
ZA
Mw
wY
ZA
ZA
cQ
av
ZA
ZA
rA
ZA
ZA
ZA
ZA
ZA
Dh
Dh
Dh
Fd
ab
"}
(19,1,1) = {"
ab
ab
ab
ab
ab
ab
ab
ab
ab
ab
ab
ab
ab
ab
di
ZA
ZA
ZA
Mw
ZA
ZA
ZA
ZA
ZA
ZA
ZA
oC
Tc
lg
Xt
ZA
Mw
ZA
ZA
ZA
ZA
Dh
dh
Fj
Dh
Fd
ab
"}
(20,1,1) = {"
ab
ab
ab
ab
ab
ab
ab
ab
ab
ab
ab
ab
ab
ab
di
Se
Se
Se
AH
AH
UO
wY
ZA
tS
ZA
ZA
ZA
XC
HR
ZA
ZA
ZA
ZA
Yp
ZA
ZA
ZA
Dh
Dh
Dh
Fd
ab
"}
(21,1,1) = {"
ab
ab
ab
ab
ab
ab
ab
ab
ab
ab
ab
ab
ab
ab
di
AH
Xr
AH
Xr
Ck
UO
ZA
ZA
Mw
wY
ZA
ZA
Yp
ZA
ZA
wY
ZA
ZA
Mw
ZA
ZA
ZA
ZA
Od
Dh
Fd
ab
"}
(22,1,1) = {"
ab
ab
ab
ab
ab
ab
ab
ab
ab
ab
ab
ab
ab
ab
di
Ck
Ck
Xv
Ck
Xv
UO
ZA
ZA
Yp
ZA
ZA
Mw
bZ
yW
aR
ZA
Yp
ZA
ZA
ZA
ZA
ZA
ZA
ZA
Dh
Fd
ab
"}
(23,1,1) = {"
ab
ab
ab
ab
ab
ab
ab
ab
ab
ab
ab
ab
ab
ab
di
AH
AH
tS
AH
Ck
UO
ZA
wY
ZA
ZA
ZA
ZA
ZA
ZA
ZA
ZA
ZA
wq
ZA
ZA
ZA
ZA
ZA
ZA
ZA
Fd
ab
"}
(24,1,1) = {"
ab
ab
ab
ab
ab
ab
ab
ab
ab
ab
ab
ab
ab
ab
di
Av
Se
Se
Se
Ck
UO
ZA
Oq
ZA
Mw
ZA
Wc
FO
Yp
wY
Mw
Dh
Jy
Dh
ZA
ZA
ZA
ZA
bV
ZA
Fd
ab
"}
(25,1,1) = {"
ab
ab
ab
ab
ab
ab
ab
ab
ab
ab
ab
ab
ab
ab
di
AH
Xr
Se
Xr
AH
UO
ZA
Ev
ZA
ZA
wY
ZA
ZA
Yp
Yp
ZA
Dh
Fm
ZA
ZA
ZA
ZA
ZK
ZA
ZA
di
ab
"}
(26,1,1) = {"
ab
ab
ab
ab
ab
ab
ab
ab
ab
ab
ab
ab
ab
ab
di
AH
AH
AH
Av
AH
Av
ZA
wY
ZA
Mw
ZA
Yp
ZA
ZA
ZA
ZA
Mw
ZA
ZA
ZA
ZA
ZA
ZA
ZA
ZA
di
ab
"}
(27,1,1) = {"
ab
ab
ab
ab
ab
ab
ab
ab
ab
ab
ab
ab
ab
ab
di
AH
mS
mS
rr
rr
AH
ZA
ZA
ZA
wY
ZA
ZA
wY
Dh
Dh
ZA
ZA
ZA
ZA
Dh
Dh
ZA
ZA
ZA
ZA
di
ab
"}
(28,1,1) = {"
ab
ab
ab
ab
ab
ab
ab
ab
ab
ab
ab
ab
ab
ab
di
di
di
di
di
di
di
di
di
di
di
di
di
Fd
Fd
Fd
di
di
di
Fd
Fd
Fd
Fd
di
di
di
di
ab
"}
(29,1,1) = {"
ab
ab
ab
ab
ab
ab
ab
ab
ab
ab
ab
ab
ab
ab
ab
ab
ab
ab
ab
ab
ab
ab
ab
ab
ab
ab
ab
ab
ab
ab
ab
ab
ab
ab
ab
ab
ab
ab
ab
ab
ab
ab
"}
(30,1,1) = {"
ab
ab
ab
ab
ab
ab
ab
ab
ab
ab
ab
ab
ab
ab
ab
ab
ab
ab
gP
gP
gP
gP
gP
gP
gP
gP
gP
gP
gP
gP
gP
gP
gP
ab
ab
ab
ab
ab
ab
ab
ab
ab
"}
(31,1,1) = {"
ab
ab
ab
ab
ab
ab
ab
ab
ab
ab
ab
ab
ab
ab
ab
ab
ab
ab
gP
pe
gu
gu
gu
gu
gu
gu
gu
gu
gu
gu
gu
pe
gP
ab
ab
ab
ab
ab
ab
ab
ab
ab
"}
(32,1,1) = {"
ab
ab
ab
ab
ab
ab
ab
ab
ab
ab
ab
ab
ab
ab
ab
ab
ab
ab
gP
gu
gu
gu
gu
gu
gu
gu
gu
gu
gu
gu
gu
gu
gP
ab
ab
ab
ab
ab
ab
ab
ab
ab
"}
(33,1,1) = {"
ab
ab
ab
ab
ab
ab
ab
ab
ab
ab
ab
ab
ab
ab
ab
ab
ab
ab
gP
gu
gu
bf
mP
El
oF
El
oF
El
mD
de
gu
gu
gP
ab
ab
ab
ab
ab
ab
ab
ab
ab
"}
(34,1,1) = {"
ab
ab
ab
ab
ab
ab
ab
ab
ab
ab
ab
ab
ab
ab
ab
ab
ab
ab
gP
gu
gu
br
JX
oF
El
oF
El
oF
Kw
Yj
gu
gu
gP
ab
ab
ab
ab
ab
ab
ab
ab
ab
"}
(35,1,1) = {"
ab
ab
ab
ab
ab
ab
ab
ab
ab
ab
ab
ab
ab
ab
ab
ab
ab
ab
gP
gu
gu
cj
mP
El
oF
El
oF
El
mD
Cw
gu
gu
gP
ab
ab
ab
ab
ab
ab
ab
ab
ab
"}
(36,1,1) = {"
ab
ab
ab
ab
ab
ab
ab
ab
ab
ab
ab
ab
ab
ab
ab
ab
ab
ab
gP
gu
gu
ct
JX
oF
El
Yf
El
oF
Kw
jT
gu
gu
gP
ab
ab
ab
ab
ab
ab
ab
ab
ab
"}
(37,1,1) = {"
ab
ab
ab
ab
ab
ab
ab
ab
ab
ab
ab
ab
ab
ab
ab
ab
ab
ab
gP
gu
gu
dE
mP
El
oF
El
oF
El
mD
PU
gu
gu
gP
ab
ab
ab
ab
ab
ab
ab
ab
ab
"}
(38,1,1) = {"
ab
ab
ab
ab
ab
ab
ab
ab
ab
ab
ab
ab
ab
ab
ab
ab
ab
ab
gP
gu
gu
dJ
JX
oF
El
oF
El
oF
Kw
JP
gu
gu
gP
ab
ab
ab
ab
ab
ab
ab
ab
ab
"}
(39,1,1) = {"
ab
ab
ab
ab
ab
ab
ab
ab
ab
ab
ab
ab
ab
ab
ab
ab
ab
ab
gP
gu
gu
fb
mP
El
oF
El
oF
El
mD
Iq
gu
gu
gP
ab
ab
ab
ab
ab
ab
ab
ab
ab
"}
(40,1,1) = {"
ab
ab
ab
ab
ab
ab
ab
ab
ab
ab
ab
ab
ab
ab
ab
ab
ab
ab
gP
gu
gu
gw
JX
oF
El
oF
El
oF
Kw
pN
gu
gu
gP
ab
ab
ab
ab
ab
ab
ab
ab
ab
"}
(41,1,1) = {"
ab
ab
ab
ab
ab
ab
ab
ab
ab
ab
ab
ab
ab
ab
ab
ab
ab
ab
gP
gu
gu
gu
gu
gu
gu
gu
gu
gu
gu
gu
gu
gu
gP
ab
ab
ab
ab
ab
ab
ab
ab
ab
"}
(42,1,1) = {"
ab
ab
ab
ab
ab
ab
ab
ab
ab
ab
ab
ab
ab
ab
ab
ab
ab
ab
gP
pe
gu
gu
gu
gu
gu
gu
gu
gu
gu
gu
gu
pe
gP
ab
ab
ab
ab
ab
ab
ab
ab
ab
"}
(43,1,1) = {"
ab
ab
ab
ab
ab
ab
ab
ab
ab
ab
ab
ab
ab
ab
ab
ab
ab
ab
gP
gP
gP
gP
gP
gP
gP
gP
gP
gP
gP
gP
gP
gP
gP
ab
ab
ab
ab
ab
ab
ab
ab
ab
"}
(44,1,1) = {"
ab
ab
ab
ab
ab
ab
ab
ab
ab
ab
ab
ab
ab
ab
ab
ab
ab
ab
ab
ab
ab
ab
ab
ab
ab
ab
ab
ab
ab
ab
ab
ab
ab
ab
ab
ab
ab
ab
ab
ab
ab
ab
"}
(45,1,1) = {"
ab
ab
ab
ab
ab
ab
ab
ab
ab
ab
ab
ab
ab
ab
ab
ab
ab
ab
ab
ab
ab
ab
ab
ab
ab
ab
ab
ab
ab
ab
ab
ab
ab
ab
ab
ab
ab
ab
ab
ab
ab
ab
"}
