//MAP CONVERTED BY dmm2tgm.py THIS HEADER COMMENT PREVENTS RECONVERSION, DO NOT REMOVE
"a" = (
/obj/effect/turf_decal/trimline/yellow/arrow_ccw{
	dir = 4
	},
/obj/effect/turf_decal/trimline/yellow/filled/corner,
/obj/effect/turf_decal/trimline/yellow/filled/corner{
	dir = 4
	},
/turf/open/floor/iron/smooth_large,
/area/shuttle/prison_shuttle)
"b" = (
/turf/closed/wall/mineral/titanium,
/area/shuttle/prison_shuttle)
"e" = (
/obj/effect/turf_decal/trimline/yellow/arrow_ccw{
	dir = 4
	},
/obj/effect/turf_decal/trimline/yellow/filled/line{
	dir = 4
	},
/obj/item/radio/intercom/prison/directional/east,
/turf/open/floor/iron/smooth_large,
/area/shuttle/prison_shuttle)
"g" = (
/obj/machinery/door/airlock/titanium{
	name = "Prison Ship Airlock"
	},
/obj/effect/turf_decal/trimline/yellow/filled/line,
/obj/effect/turf_decal/trimline/yellow/filled/line{
	dir = 1
	},
/turf/open/floor/iron/smooth_large,
/area/shuttle/prison_shuttle)
"h" = (
/obj/effect/turf_decal/trimline/yellow/filled/line{
	dir = 5
	},
/obj/machinery/conveyor/inverted{
	dir = 6;
	id = "prisonshuttle"
	},
/turf/open/floor/iron/smooth_large,
/area/shuttle/prison_shuttle)
"i" = (
/obj/docking_port/mobile/prison,
/obj/machinery/door/airlock/titanium{
	name = "Prison Ship Airlock"
	},
/obj/effect/turf_decal/trimline/yellow/filled/line,
/obj/effect/turf_decal/trimline/yellow/filled/line{
	dir = 1
	},
/turf/open/floor/iron/smooth_large,
/area/shuttle/prison_shuttle)
"j" = (
/obj/effect/turf_decal/trimline/yellow/arrow_ccw{
	dir = 5
	},
/obj/effect/turf_decal/trimline/yellow/filled/line{
	dir = 4
	},
/obj/machinery/conveyor{
	dir = 1;
	id = "prisonshuttle"
	},
/turf/open/floor/iron/smooth_large,
/area/shuttle/prison_shuttle)
"k" = (
/obj/effect/turf_decal/trimline/yellow/filled/line{
	dir = 1
	},
/obj/machinery/conveyor/inverted{
	dir = 4;
	id = "prisonshuttle"
	},
/turf/open/floor/iron/smooth_large,
/area/shuttle/prison_shuttle)
"l" = (
/obj/machinery/light/directional/west,
/obj/effect/turf_decal/trimline/yellow/filled/line{
	dir = 8
	},
/obj/machinery/conveyor{
	id = "prisonshuttle"
	},
/turf/open/floor/iron/smooth_large,
/area/shuttle/prison_shuttle)
"o" = (
/obj/effect/turf_decal/trimline/yellow/filled/line{
	dir = 6
	},
/obj/machinery/conveyor/inverted{
	dir = 8;
	id = "prisonshuttle"
	},
/turf/open/floor/iron/smooth_large,
/area/shuttle/prison_shuttle)
"q" = (
/obj/structure/window/reinforced{
	dir = 1
	},
/obj/structure/shuttle/engine/heater,
/turf/open/floor/plating/airless,
/area/shuttle/prison_shuttle)
"r" = (
/obj/effect/turf_decal/trimline/yellow/arrow_ccw{
	dir = 9
	},
/turf/open/floor/iron/smooth_large,
/area/shuttle/prison_shuttle)
"s" = (
/turf/template_noop,
/area/template_noop)
"t" = (
/obj/structure/shuttle/engine/propulsion/burst/left,
/turf/open/floor/plating/airless,
/area/shuttle/prison_shuttle)
"u" = (
/obj/structure/shuttle/engine/propulsion,
/turf/open/floor/plating/airless,
/area/shuttle/prison_shuttle)
"v" = (
/obj/structure/shuttle/engine/propulsion/burst/right,
/turf/open/floor/plating/airless,
/area/shuttle/prison_shuttle)
"w" = (
/obj/effect/turf_decal/trimline/yellow/filled/line{
	dir = 1
	},
/obj/machinery/recycler,
/obj/machinery/conveyor/inverted{
	dir = 4;
	id = "prisonshuttle"
	},
/turf/open/floor/iron/smooth_large,
/area/shuttle/prison_shuttle)
"x" = (
/obj/effect/turf_decal/trimline/yellow/filled/line{
	dir = 8
	},
/obj/machinery/conveyor{
	id = "prisonshuttle"
	},
/turf/open/floor/iron/smooth_large,
/area/shuttle/prison_shuttle)
"y" = (
/obj/effect/turf_decal/trimline/yellow/arrow_ccw{
	dir = 1
	},
/turf/open/floor/iron/smooth_large,
/area/shuttle/prison_shuttle)
"z" = (
/obj/effect/turf_decal/trimline/yellow/filled/line,
/obj/machinery/conveyor/inverted{
	dir = 8;
	id = "prisonshuttle"
	},
/obj/machinery/recycler{
	dir = 1
	},
/turf/open/floor/iron/smooth_large,
/area/shuttle/prison_shuttle)
"A" = (
/obj/machinery/smartfridge/prison/disposal,
/turf/closed/wall/mineral/titanium,
/area/shuttle/prison_shuttle)
"B" = (
/obj/effect/turf_decal/trimline/yellow/arrow_ccw,
/turf/open/floor/iron/smooth_large,
/area/shuttle/prison_shuttle)
"C" = (
/turf/open/floor/iron/smooth_large,
/area/shuttle/prison_shuttle)
"D" = (
/obj/effect/turf_decal/trimline/yellow/arrow_ccw{
	dir = 6
	},
/obj/effect/turf_decal/trimline/yellow/filled/line{
	dir = 4
	},
/turf/open/floor/iron/smooth_large,
/area/shuttle/prison_shuttle)
"F" = (
/obj/effect/turf_decal/trimline/yellow/end{
	dir = 8
	},
/turf/open/floor/iron/smooth_large,
/area/shuttle/prison_shuttle)
"G" = (
/obj/effect/turf_decal/trimline/yellow/end{
	dir = 4
	},
/turf/open/floor/iron/smooth_large,
/area/shuttle/prison_shuttle)
"I" = (
/obj/effect/turf_decal/trimline/yellow/arrow_ccw{
	dir = 8
	},
/obj/structure/sign/poster/official/do_not_question{
	pixel_x = -32
	},
/obj/machinery/conveyor_switch/oneway{
	dir = 8;
	id = "prisonshuttle";
	name = "disposal conveyor"
	},
/turf/open/floor/iron/smooth_large,
/area/shuttle/prison_shuttle)
"J" = (
/obj/effect/turf_decal/trimline/yellow/arrow_ccw{
	dir = 10
	},
/turf/open/floor/iron/smooth_large,
/area/shuttle/prison_shuttle)
"K" = (
/obj/effect/turf_decal/trimline/yellow/arrow_ccw{
	dir = 8
	},
/turf/open/floor/iron/smooth_large,
/area/shuttle/prison_shuttle)
"M" = (
/obj/effect/turf_decal/trimline/yellow/arrow_ccw{
	dir = 4
	},
/obj/effect/turf_decal/trimline/yellow/filled/line{
	dir = 4
	},
/obj/structure/sign/poster/official/obey{
	pixel_x = 30
	},
/turf/open/floor/iron/smooth_large,
/area/shuttle/prison_shuttle)
"O" = (
/obj/machinery/light/directional/north,
/obj/effect/turf_decal/trimline/yellow/filled/line{
	dir = 1
	},
/obj/machinery/conveyor/inverted{
	dir = 4;
	id = "prisonshuttle"
	},
/turf/open/floor/iron/smooth_large,
/area/shuttle/prison_shuttle)
"P" = (
/obj/machinery/conveyor/inverted{
	dir = 8;
	id = "prisonshuttle"
	},
/obj/effect/turf_decal/trimline/yellow/corner{
	dir = 4
	},
/obj/effect/turf_decal/trimline/yellow/filled/line,
/turf/open/floor/iron/smooth_large,
/area/shuttle/prison_shuttle)
"R" = (
/obj/structure/closet/crate/mail/prison,
/turf/open/floor/iron/smooth_large,
/area/shuttle/prison_shuttle)
"S" = (
/obj/machinery/conveyor/inverted{
	dir = 9;
	id = "prisonshuttle"
	},
/obj/effect/turf_decal/trimline/yellow/filled/line{
	dir = 10
	},
/turf/open/floor/iron/smooth_large,
/area/shuttle/prison_shuttle)
"T" = (
/obj/machinery/light/directional/south,
/obj/effect/turf_decal/trimline/yellow/filled/line,
/obj/machinery/conveyor/inverted{
	dir = 8;
	id = "prisonshuttle"
	},
/turf/open/floor/iron/smooth_large,
/area/shuttle/prison_shuttle)
"U" = (
/obj/machinery/light/directional/east,
/obj/effect/turf_decal/trimline/yellow/arrow_ccw{
	dir = 4
	},
/obj/effect/turf_decal/trimline/yellow/filled/line{
	dir = 4
	},
/turf/open/floor/iron/smooth_large,
/area/shuttle/prison_shuttle)
"V" = (
/obj/effect/turf_decal/trimline/yellow/filled/line{
	dir = 9
	},
/obj/machinery/conveyor/inverted{
	dir = 5;
	id = "prisonshuttle"
	},
/turf/open/floor/iron/smooth_large,
/area/shuttle/prison_shuttle)

(1,1,1) = {"
b
b
b
b
b
b
b
b
b
b
b
s
"}
(2,1,1) = {"
b
V
x
l
x
b
x
l
x
S
b
t
"}
(3,1,1) = {"
b
w
r
K
K
I
K
K
J
P
q
u
"}
(4,1,1) = {"
b
O
y
F
R
C
R
F
B
T
q
u
"}
(5,1,1) = {"
b
k
y
G
R
R
R
G
B
z
q
u
"}
(6,1,1) = {"
b
h
j
M
a
U
a
e
D
o
b
v
"}
(7,1,1) = {"
b
b
b
b
g
A
i
b
b
b
b
s
"}
