//MAP CONVERTED BY dmm2tgm.py THIS HEADER COMMENT PREVENTS RECONVERSION, DO NOT REMOVE
"b" = (
/turf/closed/wall/mineral/titanium,
/area/shuttle/prison_shuttle)
"g" = (
/obj/machinery/door/airlock/titanium{
	name = "Supply Shuttle Airlock";
	req_access_txt = "31"
	},
/obj/effect/turf_decal/trimline/purple/filled/line{
	dir = 1
	},
/turf/open/floor/iron/textured_large,
/area/shuttle/prison_shuttle)
"h" = (
/obj/machinery/light/directional/east,
/turf/open/floor/iron/textured_large,
/area/shuttle/prison_shuttle)
"i" = (
/obj/machinery/door/airlock/titanium{
	name = "Supply Shuttle Airlock";
	req_access_txt = "31"
	},
/obj/docking_port/mobile/prison,
/obj/effect/turf_decal/trimline/purple/filled/line,
/turf/open/floor/iron/textured_large,
/area/shuttle/prison_shuttle)
"q" = (
/obj/structure/window/reinforced{
	dir = 1
	},
/obj/structure/shuttle/engine/heater,
/turf/open/floor/plating/airless,
/area/shuttle/prison_shuttle)
"s" = (
/turf/template_noop,
/area/template_noop)
"t" = (
/obj/structure/shuttle/engine/propulsion/burst/left,
/turf/open/floor/plating/airless,
/area/shuttle/prison_shuttle)
"u" = (
/obj/structure/shuttle/engine/propulsion,
/turf/open/floor/plating/airless,
/area/shuttle/prison_shuttle)
"v" = (
/obj/structure/shuttle/engine/propulsion/burst/right,
/turf/open/floor/plating/airless,
/area/shuttle/prison_shuttle)
"V" = (
/turf/open/floor/iron/textured_large,
/area/shuttle/prison_shuttle)
"W" = (
/obj/machinery/light/directional/west,
/turf/open/floor/iron/textured_large,
/area/shuttle/prison_shuttle)

(1,1,1) = {"
b
b
b
b
b
b
b
b
b
b
b
s
"}
(2,1,1) = {"
b
V
V
W
V
V
V
W
V
V
b
t
"}
(3,1,1) = {"
b
V
V
V
V
V
V
V
V
V
q
u
"}
(4,1,1) = {"
b
V
V
V
V
V
V
V
V
V
q
u
"}
(5,1,1) = {"
b
V
V
V
V
V
V
V
V
V
q
u
"}
(6,1,1) = {"
b
h
V
V
V
h
V
V
V
h
b
v
"}
(7,1,1) = {"
b
b
b
b
g
b
i
b
b
b
b
s
"}
