//MAP CONVERTED BY dmm2tgm.py THIS HEADER COMMENT PREVENTS RECONVERSION, DO NOT REMOVE
"a" = (
/obj/effect/decal/cleanable/blood/xtracks,
/obj/structure/mopbucket,
/turf/open/floor/iron/textured_large,
/area/shuttle/prison_shuttle)
"b" = (
/turf/closed/wall/mineral/titanium,
/area/shuttle/prison_shuttle)
"c" = (
/obj/effect/spawner/random/maintenance/two,
/turf/open/floor/iron/textured_large,
/area/shuttle/prison_shuttle)
"f" = (
/obj/effect/spawner/random/trash/mess,
/turf/open/floor/iron/textured_large,
/area/shuttle/prison_shuttle)
"g" = (
/obj/machinery/door/airlock/titanium{
	name = "Prison Ship Airlock"
	},
/turf/open/floor/iron/textured_large,
/area/shuttle/prison_shuttle)
"h" = (
/obj/effect/decal/cleanable/food/flour,
/turf/open/floor/iron/textured_large,
/area/shuttle/prison_shuttle)
"i" = (
/obj/docking_port/mobile/prison,
/obj/machinery/door/airlock/titanium{
	name = "Prison Ship Airlock"
	},
/turf/open/floor/iron/textured_large,
/area/shuttle/prison_shuttle)
"j" = (
/obj/item/cigbutt/roach,
/obj/effect/decal/cleanable/blood/tracks{
	dir = 4
	},
/obj/effect/decal/cleanable/blood/xtracks,
/turf/open/floor/iron/textured_large,
/area/shuttle/prison_shuttle)
"k" = (
/obj/effect/decal/cleanable/oil,
/obj/effect/decal/cleanable/blood/old,
/turf/open/floor/iron/textured_large,
/area/shuttle/prison_shuttle)
"m" = (
/obj/effect/spawner/random/trash/mess,
/obj/effect/decal/cleanable/blood/xtracks,
/turf/open/floor/iron/textured_large,
/area/shuttle/prison_shuttle)
"n" = (
/obj/machinery/light/directional/east,
/obj/effect/decal/cleanable/oil,
/obj/effect/spawner/random/trash/caution_sign,
/turf/open/floor/iron/textured_large,
/area/shuttle/prison_shuttle)
"p" = (
/obj/effect/decal/cleanable/oil,
/obj/effect/decal/cleanable/blood/xtracks,
/turf/open/floor/iron/textured_large,
/area/shuttle/prison_shuttle)
"q" = (
/obj/structure/window/reinforced{
	dir = 1
	},
/obj/structure/shuttle/engine/heater,
/obj/structure/window/reinforced{
	dir = 4
	},
/turf/open/floor/plating/airless,
/area/shuttle/prison_shuttle)
"s" = (
/turf/template_noop,
/area/template_noop)
"t" = (
/obj/structure/shuttle/engine/propulsion/burst/left,
/turf/open/floor/plating/airless,
/area/shuttle/prison_shuttle)
"u" = (
/obj/structure/shuttle/engine/propulsion,
/turf/open/floor/plating/airless,
/area/shuttle/prison_shuttle)
"v" = (
/obj/structure/shuttle/engine/propulsion/burst/right,
/turf/open/floor/plating/airless,
/area/shuttle/prison_shuttle)
"w" = (
/obj/effect/spawner/random/trash/garbage{
	spawn_scatter_radius = 1
	},
/obj/effect/decal/cleanable/blood/xtracks,
/turf/open/floor/iron/textured_large,
/area/shuttle/prison_shuttle)
"x" = (
/obj/effect/spawner/random/bureaucracy/stamp,
/obj/effect/decal/cleanable/blood/xtracks,
/turf/open/floor/iron/textured_large,
/area/shuttle/prison_shuttle)
"y" = (
/obj/effect/spawner/random/trash/garbage{
	spawn_scatter_radius = 1
	},
/obj/effect/decal/cleanable/blood/tracks{
	dir = 4
	},
/turf/open/floor/iron/textured_large,
/area/shuttle/prison_shuttle)
"B" = (
/obj/effect/decal/cleanable/blood/tracks{
	dir = 4
	},
/obj/effect/decal/cleanable/oil/slippery,
/turf/open/floor/iron/textured_large,
/area/shuttle/prison_shuttle)
"C" = (
/obj/effect/decal/cleanable/oil,
/turf/open/floor/iron/textured_large,
/area/shuttle/prison_shuttle)
"D" = (
/obj/effect/decal/cleanable/food/flour,
/obj/effect/spawner/random/maintenance,
/turf/open/floor/iron/textured_large,
/area/shuttle/prison_shuttle)
"E" = (
/obj/effect/spawner/random/trash/garbage{
	spawn_scatter_radius = 1
	},
/obj/effect/spawner/random/trash/mess,
/obj/effect/decal/cleanable/chem_pile,
/turf/open/floor/iron/textured_large,
/area/shuttle/prison_shuttle)
"F" = (
/obj/effect/spawner/random/trash/garbage{
	spawn_scatter_radius = 1
	},
/obj/effect/spawner/random/maintenance,
/obj/effect/decal/cleanable/cobweb,
/turf/open/floor/iron/textured_large,
/area/shuttle/prison_shuttle)
"G" = (
/obj/effect/spawner/random/trash/garbage{
	spawn_scatter_radius = 1
	},
/obj/effect/decal/cleanable/crayon,
/turf/open/floor/iron/textured_large,
/area/shuttle/prison_shuttle)
"H" = (
/obj/item/cigbutt{
	pixel_y = 7
	},
/obj/effect/decal/cleanable/blood/old,
/turf/open/floor/iron/textured_large,
/area/shuttle/prison_shuttle)
"I" = (
/obj/machinery/light/directional/west,
/obj/effect/spawner/random/trash/garbage{
	spawn_scatter_radius = 1
	},
/obj/effect/spawner/random/trash/mess,
/obj/effect/spawner/random/maintenance,
/obj/effect/decal/cleanable/blood/tracks{
	dir = 4
	},
/turf/open/floor/iron/textured_large,
/area/shuttle/prison_shuttle)
"J" = (
/obj/effect/spawner/random/maintenance,
/turf/open/floor/iron/textured_large,
/area/shuttle/prison_shuttle)
"K" = (
/obj/effect/spawner/random/maintenance,
/obj/effect/decal/cleanable/glass,
/turf/open/floor/iron/textured_large,
/area/shuttle/prison_shuttle)
"M" = (
/obj/structure/window/reinforced{
	dir = 1
	},
/obj/structure/shuttle/engine/heater,
/obj/structure/window/reinforced{
	dir = 8
	},
/turf/open/floor/plating/airless,
/area/shuttle/prison_shuttle)
"N" = (
/obj/structure/shuttle/engine/heater,
/obj/effect/decal/cleanable/glass,
/obj/structure/window/reinforced,
/turf/open/floor/plating/airless,
/area/shuttle/prison_shuttle)
"O" = (
/obj/effect/spawner/random/trash/mess,
/obj/effect/decal/cleanable/oil/slippery,
/turf/open/floor/iron/textured_large,
/area/shuttle/prison_shuttle)
"P" = (
/obj/item/radio/intercom/prison/directional/east,
/obj/effect/decal/cleanable/oil,
/turf/open/floor/iron/textured_large,
/area/shuttle/prison_shuttle)
"R" = (
/obj/effect/decal/cleanable/blood/tracks{
	dir = 4
	},
/turf/open/floor/iron/textured_large,
/area/shuttle/prison_shuttle)
"S" = (
/obj/effect/decal/cleanable/blood/old,
/obj/effect/decal/cleanable/chem_pile,
/turf/open/floor/iron/textured_large,
/area/shuttle/prison_shuttle)
"T" = (
/obj/effect/spawner/random/trash/mess,
/obj/effect/decal/cleanable/blood/tracks{
	dir = 4
	},
/turf/open/floor/iron/textured_large,
/area/shuttle/prison_shuttle)
"U" = (
/obj/effect/spawner/random/trash/garbage{
	spawn_scatter_radius = 1
	},
/turf/open/floor/iron/textured_large,
/area/shuttle/prison_shuttle)
"V" = (
/turf/open/floor/iron/textured_large,
/area/shuttle/prison_shuttle)
"W" = (
/obj/machinery/light/directional/west,
/obj/effect/spawner/random/trash/garbage{
	spawn_scatter_radius = 1
	},
/turf/open/floor/iron/textured_large,
/area/shuttle/prison_shuttle)
"X" = (
/obj/effect/decal/cleanable/blood/old,
/turf/open/floor/iron/textured_large,
/area/shuttle/prison_shuttle)

(1,1,1) = {"
b
b
b
b
b
b
b
b
b
b
b
s
"}
(2,1,1) = {"
b
F
U
W
c
X
f
I
U
U
b
t
"}
(3,1,1) = {"
b
a
x
w
H
k
R
T
f
U
q
u
"}
(4,1,1) = {"
b
f
f
m
p
p
j
V
G
K
N
u
"}
(5,1,1) = {"
b
D
E
S
U
U
y
U
J
V
M
u
"}
(6,1,1) = {"
b
h
f
f
O
n
B
P
C
U
b
v
"}
(7,1,1) = {"
b
b
b
b
g
b
i
b
b
b
b
s
"}
