//MAP CONVERTED BY dmm2tgm.py THIS HEADER COMMENT PREVENTS RECONVERSION, DO NOT REMOVE
"a" = (
/obj/structure/table,
/obj/structure/sign/picture_frame/portrait/bar{
	pixel_x = -28;
	pixel_y = 4
	},
/obj/machinery/chem_dispenser/drinks{
	dir = 4
	},
/turf/open/floor/carpet/black,
/area/shuttle/prison_shuttle)
"b" = (
/turf/closed/wall/mineral/titanium,
/area/shuttle/prison_shuttle)
"f" = (
/obj/structure/table,
/obj/structure/displaycase/forsale/kitchen{
	pixel_y = 8
	},
/turf/open/floor/carpet/black,
/area/shuttle/prison_shuttle)
"g" = (
/obj/machinery/door/airlock/titanium{
	name = "Prison Ship Airlock"
	},
/turf/open/floor/iron/textured_large,
/area/shuttle/prison_shuttle)
"h" = (
/obj/machinery/light/small/directional/east,
/turf/open/floor/iron/textured_large,
/area/shuttle/prison_shuttle)
"i" = (
/obj/docking_port/mobile/prison,
/obj/machinery/door/airlock/titanium{
	name = "Prison Ship Airlock"
	},
/turf/open/floor/iron/textured_large,
/area/shuttle/prison_shuttle)
"k" = (
/obj/machinery/chem_master/condimaster{
	desc = "Looks like a knock-off chem-master. Perhaps useful for separating liquids when mixing drinks precisely. Also dispenses condiments.";
	name = "HoochMaster Deluxe"
	},
/turf/open/floor/carpet/black,
/area/shuttle/prison_shuttle)
"l" = (
/obj/structure/table,
/turf/open/floor/carpet/black,
/area/shuttle/prison_shuttle)
"o" = (
/obj/structure/table,
/obj/machinery/chem_dispenser/drinks/beer{
	dir = 4
	},
/turf/open/floor/carpet/black,
/area/shuttle/prison_shuttle)
"p" = (
/obj/structure/table,
/obj/machinery/reagentgrinder{
	pixel_y = 10
	},
/turf/open/floor/carpet/black,
/area/shuttle/prison_shuttle)
"q" = (
/obj/structure/window/reinforced{
	dir = 1
	},
/obj/structure/shuttle/engine/heater,
/turf/open/floor/plating/airless,
/area/shuttle/prison_shuttle)
"r" = (
/obj/machinery/smartfridge/prison/bar,
/turf/closed/wall/mineral/titanium,
/area/shuttle/prison_shuttle)
"s" = (
/turf/template_noop,
/area/template_noop)
"t" = (
/obj/structure/shuttle/engine/propulsion/burst/left,
/turf/open/floor/plating/airless,
/area/shuttle/prison_shuttle)
"u" = (
/obj/structure/shuttle/engine/propulsion,
/turf/open/floor/plating/airless,
/area/shuttle/prison_shuttle)
"v" = (
/obj/structure/shuttle/engine/propulsion/burst/right,
/turf/open/floor/plating/airless,
/area/shuttle/prison_shuttle)
"x" = (
/obj/item/radio/intercom/prison/directional/east,
/turf/open/floor/iron/textured_large,
/area/shuttle/prison_shuttle)
"A" = (
/obj/structure/table,
/obj/item/stack/package_wrap{
	pixel_x = -4;
	pixel_y = 6
	},
/obj/item/stack/package_wrap{
	pixel_x = 10;
	pixel_y = -6
	},
/turf/open/floor/carpet/black,
/area/shuttle/prison_shuttle)
"F" = (
/obj/structure/table,
/obj/item/book/manual/wiki/barman_recipes{
	pixel_x = 5;
	pixel_y = 6
	},
/obj/item/reagent_containers/glass/rag,
/turf/open/floor/carpet/black,
/area/shuttle/prison_shuttle)
"H" = (
/obj/machinery/vending/boozeomat,
/turf/open/floor/carpet/black,
/area/shuttle/prison_shuttle)
"I" = (
/obj/structure/chair/stool/bar/directional/west,
/turf/open/floor/iron/textured_large,
/area/shuttle/prison_shuttle)
"S" = (
/obj/structure/table,
/obj/machinery/light/small/directional/west,
/obj/item/reagent_containers/food/drinks/shaker{
	pixel_x = -6
	},
/turf/open/floor/carpet/black,
/area/shuttle/prison_shuttle)
"T" = (
/obj/structure/table,
/obj/item/lighter,
/turf/open/floor/carpet/black,
/area/shuttle/prison_shuttle)
"V" = (
/turf/open/floor/iron/textured_large,
/area/shuttle/prison_shuttle)
"W" = (
/obj/machinery/light/small/directional/west,
/turf/open/floor/carpet/black,
/area/shuttle/prison_shuttle)
"Y" = (
/turf/open/floor/carpet/black,
/area/shuttle/prison_shuttle)
"Z" = (
/obj/structure/sink/kitchen{
	dir = 4;
	layer = 1;
	name = "utility sink";
	pixel_x = -12;
	pixel_y = -2
	},
/turf/open/floor/carpet/black,
/area/shuttle/prison_shuttle)

(1,1,1) = {"
b
b
b
b
b
b
b
b
b
b
b
s
"}
(2,1,1) = {"
b
Y
Y
W
Z
a
o
S
p
k
b
t
"}
(3,1,1) = {"
b
Y
Y
Y
Y
Y
Y
Y
Y
Y
q
u
"}
(4,1,1) = {"
b
Y
H
f
A
l
l
T
l
F
q
u
"}
(5,1,1) = {"
b
V
V
I
I
I
I
I
I
I
q
u
"}
(6,1,1) = {"
b
V
V
V
V
h
V
x
V
V
b
v
"}
(7,1,1) = {"
b
b
b
b
g
r
i
b
b
b
b
s
"}
