//MAP CONVERTED BY dmm2tgm.py THIS HEADER COMMENT PREVENTS RECONVERSION, DO NOT REMOVE
"b" = (
/turf/closed/wall/mineral/titanium,
/area/shuttle/prison_shuttle)
"c" = (
/obj/effect/turf_decal/siding/brown{
	color = "#FF6700";
	dir = 1;
	name = "prison orange"
	},
/obj/machinery/plate_press,
/turf/open/floor/iron,
/area/shuttle/prison_shuttle)
"e" = (
/obj/effect/turf_decal/siding/brown{
	color = "#FF6700";
	dir = 4
	},
/obj/structure/table,
/obj/machinery/light/directional/east,
/obj/effect/spawner/random/contraband/prison,
/turf/open/floor/iron,
/area/shuttle/prison_shuttle)
"f" = (
/obj/machinery/light/directional/east,
/obj/effect/turf_decal/siding/brown{
	color = "#FF6700";
	dir = 4
	},
/turf/open/floor/iron,
/area/shuttle/prison_shuttle)
"g" = (
/obj/machinery/door/airlock/titanium{
	name = "Prison Ship Airlock"
	},
/obj/effect/turf_decal/siding/brown{
	color = "#FF6700"
	},
/obj/effect/turf_decal/siding/brown{
	color = "#FF6700";
	dir = 1;
	name = "prison orange"
	},
/turf/open/floor/iron,
/area/shuttle/prison_shuttle)
"h" = (
/obj/effect/turf_decal/siding/brown{
	color = "#FF6700";
	dir = 5
	},
/obj/structure/table,
/obj/item/clothing/under/bodysash/prisoner,
/turf/open/floor/iron,
/area/shuttle/prison_shuttle)
"i" = (
/obj/docking_port/mobile/prison,
/obj/machinery/door/airlock/titanium{
	name = "Prison Ship Airlock"
	},
/obj/effect/turf_decal/siding/brown{
	color = "#FF6700"
	},
/obj/effect/turf_decal/siding/brown{
	color = "#FF6700";
	dir = 1;
	name = "prison orange"
	},
/turf/open/floor/iron,
/area/shuttle/prison_shuttle)
"k" = (
/obj/effect/turf_decal/siding/brown{
	color = "#FF6700";
	dir = 10;
	name = "prison orange"
	},
/obj/structure/table,
/obj/item/clothing/under/plasmaman/prisoner,
/obj/item/clothing/head/helmet/space/plasmaman/prisoner,
/turf/open/floor/iron,
/area/shuttle/prison_shuttle)
"m" = (
/obj/effect/turf_decal/siding/brown/corner{
	color = "#FF6700";
	name = "prison orange"
	},
/obj/effect/turf_decal/siding/brown/corner{
	color = "#FF6700";
	dir = 4;
	name = "prison orange"
	},
/turf/open/floor/iron,
/area/shuttle/prison_shuttle)
"o" = (
/obj/effect/turf_decal/siding/brown{
	color = "#FF6700";
	dir = 4
	},
/turf/open/floor/iron,
/area/shuttle/prison_shuttle)
"q" = (
/obj/structure/window/reinforced{
	dir = 1
	},
/obj/structure/shuttle/engine/heater,
/turf/open/floor/plating/airless,
/area/shuttle/prison_shuttle)
"s" = (
/turf/template_noop,
/area/template_noop)
"t" = (
/obj/structure/shuttle/engine/propulsion/burst/left,
/turf/open/floor/plating/airless,
/area/shuttle/prison_shuttle)
"u" = (
/obj/structure/shuttle/engine/propulsion,
/turf/open/floor/plating/airless,
/area/shuttle/prison_shuttle)
"v" = (
/obj/structure/shuttle/engine/propulsion/burst/right,
/turf/open/floor/plating/airless,
/area/shuttle/prison_shuttle)
"z" = (
/obj/effect/turf_decal/siding/brown{
	color = "#FF6700";
	dir = 8;
	name = "prison orange"
	},
/obj/structure/closet/crate{
	icon_state = "crateopen"
	},
/obj/item/stack/license_plates/empty/fifty,
/obj/item/stack/license_plates/empty/fifty,
/turf/open/floor/iron,
/area/shuttle/prison_shuttle)
"A" = (
/obj/effect/turf_decal/siding/brown{
	color = "#FF6700";
	dir = 8;
	name = "prison orange"
	},
/obj/structure/table,
/obj/effect/spawner/random/contraband/prison,
/turf/open/floor/iron,
/area/shuttle/prison_shuttle)
"B" = (
/obj/effect/turf_decal/siding/brown{
	color = "#FF6700"
	},
/obj/machinery/modular_computer/console/preset/civilian{
	dir = 1
	},
/turf/open/floor/iron,
/area/shuttle/prison_shuttle)
"E" = (
/obj/effect/turf_decal/siding/brown{
	color = "#FF6700";
	dir = 6
	},
/obj/structure/table,
/obj/item/tattoo_kit,
/turf/open/floor/iron,
/area/shuttle/prison_shuttle)
"G" = (
/obj/effect/turf_decal/siding/brown{
	color = "#FF6700";
	dir = 8;
	name = "prison orange"
	},
/obj/structure/table,
/obj/item/bodybag/environmental/prisoner,
/turf/open/floor/iron,
/area/shuttle/prison_shuttle)
"H" = (
/obj/effect/turf_decal/siding/brown{
	color = "#FF6700"
	},
/obj/machinery/plate_press,
/turf/open/floor/iron,
/area/shuttle/prison_shuttle)
"J" = (
/obj/effect/turf_decal/siding/brown{
	color = "#FF6700";
	dir = 4
	},
/obj/item/radio/intercom/prison/directional/east,
/turf/open/floor/iron,
/area/shuttle/prison_shuttle)
"M" = (
/obj/effect/turf_decal/siding/brown{
	color = "#FF6700";
	dir = 1;
	name = "prison orange"
	},
/obj/machinery/modular_computer/console/preset/civilian,
/turf/open/floor/iron,
/area/shuttle/prison_shuttle)
"O" = (
/turf/open/floor/iron,
/area/shuttle/prison_shuttle)
"S" = (
/obj/effect/turf_decal/siding/brown{
	color = "#FF6700";
	dir = 4
	},
/obj/structure/table,
/obj/machinery/light/directional/east,
/obj/item/stack/spacecash/c10,
/obj/item/stack/spacecash/c10{
	pixel_y = 6
	},
/turf/open/floor/iron,
/area/shuttle/prison_shuttle)
"T" = (
/obj/machinery/smartfridge/prison/license_plates,
/turf/closed/wall/mineral/titanium,
/area/shuttle/prison_shuttle)
"V" = (
/obj/effect/turf_decal/siding/brown{
	color = "#FF6700";
	dir = 9;
	name = "prison orange"
	},
/obj/structure/table,
/obj/item/tattoo_kit,
/obj/effect/spawner/random/contraband/prison,
/turf/open/floor/iron,
/area/shuttle/prison_shuttle)
"W" = (
/obj/machinery/light/directional/west,
/obj/effect/turf_decal/siding/brown{
	color = "#FF6700";
	dir = 8;
	name = "prison orange"
	},
/turf/open/floor/iron,
/area/shuttle/prison_shuttle)

(1,1,1) = {"
b
b
b
b
b
b
b
b
b
b
b
s
"}
(2,1,1) = {"
b
V
G
W
z
z
z
W
A
k
b
t
"}
(3,1,1) = {"
b
c
O
O
O
O
O
O
O
H
q
u
"}
(4,1,1) = {"
b
M
O
O
O
O
O
O
O
B
q
u
"}
(5,1,1) = {"
b
c
O
O
O
O
O
O
O
H
q
u
"}
(6,1,1) = {"
b
h
e
o
m
f
m
J
S
E
b
v
"}
(7,1,1) = {"
b
b
b
b
g
T
i
b
b
b
b
s
"}
