//MAP CONVERTED BY dmm2tgm.py THIS HEADER COMMENT PREVENTS RECONVERSION, DO NOT REMOVE
"a" = (
/obj/structure/chair{
	dir = 8
	},
/turf/open/floor/iron/white,
/area/shuttle/prison_shuttle)
"b" = (
/turf/closed/wall/mineral/titanium,
/area/shuttle/prison_shuttle)
"c" = (
/turf/open/floor/iron/white,
/area/shuttle/prison_shuttle)
"e" = (
/obj/effect/turf_decal/trimline/purple/filled/line{
	dir = 9
	},
/obj/effect/turf_decal/trimline/purple/corner,
/turf/open/floor/iron/white,
/area/shuttle/prison_shuttle)
"f" = (
/obj/effect/turf_decal/trimline/purple/filled/line{
	dir = 5
	},
/obj/effect/turf_decal/trimline/purple/corner{
	dir = 8
	},
/turf/open/floor/iron/white,
/area/shuttle/prison_shuttle)
"g" = (
/obj/effect/turf_decal/trimline/purple/filled/line{
	dir = 1
	},
/obj/machinery/door/airlock/titanium{
	name = "Prison Ship Airlock"
	},
/obj/effect/turf_decal/trimline/purple/filled/line,
/turf/open/floor/iron/white,
/area/shuttle/prison_shuttle)
"h" = (
/obj/item/storage/box/syringes,
/obj/structure/table,
/obj/item/storage/box/monkeycubes,
/obj/effect/turf_decal/trimline/purple/filled/line{
	dir = 4
	},
/turf/open/floor/iron/white,
/area/shuttle/prison_shuttle)
"i" = (
/obj/docking_port/mobile/prison,
/obj/effect/turf_decal/trimline/purple/filled/line,
/obj/machinery/door/airlock/titanium{
	name = "Prison Ship Airlock"
	},
/obj/effect/turf_decal/trimline/purple/filled/line{
	dir = 1
	},
/turf/open/floor/iron/white,
/area/shuttle/prison_shuttle)
"j" = (
/obj/effect/turf_decal/trimline/purple/filled/line{
	dir = 6
	},
/obj/effect/turf_decal/trimline/purple/corner{
	dir = 1
	},
/turf/open/floor/iron/white,
/area/shuttle/prison_shuttle)
"k" = (
/obj/effect/turf_decal/trimline/purple/filled/line{
	dir = 10
	},
/obj/effect/turf_decal/trimline/purple/corner{
	dir = 4
	},
/turf/open/floor/circuit/telecomms,
/area/shuttle/prison_shuttle)
"l" = (
/obj/effect/turf_decal/trimline/purple/filled/line{
	dir = 10
	},
/obj/effect/turf_decal/trimline/purple/corner{
	dir = 4
	},
/turf/open/floor/iron/white,
/area/shuttle/prison_shuttle)
"n" = (
/obj/machinery/processor/slime,
/obj/effect/turf_decal/trimline/purple/filled/line{
	dir = 9
	},
/turf/open/floor/iron/white,
/area/shuttle/prison_shuttle)
"p" = (
/obj/effect/turf_decal/trimline/purple/filled/line{
	dir = 5
	},
/obj/effect/turf_decal/trimline/purple/corner{
	dir = 8
	},
/obj/machinery/light/directional/east,
/turf/open/floor/iron/white,
/area/shuttle/prison_shuttle)
"q" = (
/obj/structure/window/reinforced{
	dir = 1
	},
/obj/structure/shuttle/engine/heater,
/turf/open/floor/plating/airless,
/area/shuttle/prison_shuttle)
"r" = (
/obj/effect/turf_decal/trimline/purple/filled/line{
	dir = 9
	},
/obj/effect/turf_decal/trimline/purple/corner,
/obj/machinery/camera/directional/west{
	c_tag = "Prison Xenobiology South";
	name = "Xenobiology Camera"
	},
/turf/open/floor/circuit/telecomms,
/area/shuttle/prison_shuttle)
"s" = (
/turf/template_noop,
/area/template_noop)
"t" = (
/obj/structure/shuttle/engine/propulsion/burst/left,
/turf/open/floor/plating/airless,
/area/shuttle/prison_shuttle)
"u" = (
/obj/structure/shuttle/engine/propulsion,
/turf/open/floor/plating/airless,
/area/shuttle/prison_shuttle)
"v" = (
/obj/structure/shuttle/engine/propulsion/burst/right,
/turf/open/floor/plating/airless,
/area/shuttle/prison_shuttle)
"w" = (
/obj/machinery/light/directional/north,
/obj/effect/spawner/structure/window/reinforced,
/turf/open/floor/plating,
/area/shuttle/prison_shuttle)
"x" = (
/obj/machinery/light/directional/west,
/obj/machinery/computer/camera_advanced/xenobio{
	dir = 4
	},
/obj/effect/turf_decal/trimline/purple/filled/line{
	dir = 8
	},
/obj/item/radio/intercom/prison/directional/west,
/turf/open/floor/iron/white,
/area/shuttle/prison_shuttle)
"z" = (
/obj/effect/spawner/structure/window/reinforced,
/obj/machinery/atmospherics/pipe/smart/simple/general/visible,
/turf/open/floor/plating,
/area/shuttle/prison_shuttle)
"C" = (
/obj/machinery/atmospherics/pipe/smart/simple/general/visible{
	dir = 10
	},
/obj/effect/turf_decal/trimline/purple/filled/corner{
	dir = 8
	},
/obj/effect/turf_decal/trimline/purple/filled/corner,
/turf/open/floor/iron/white,
/area/shuttle/prison_shuttle)
"D" = (
/obj/effect/turf_decal/trimline/purple/filled/line{
	dir = 6
	},
/obj/effect/turf_decal/trimline/purple/corner{
	dir = 1
	},
/turf/open/floor/circuit/telecomms,
/area/shuttle/prison_shuttle)
"F" = (
/obj/effect/turf_decal/trimline/purple/filled/line{
	dir = 6
	},
/obj/effect/turf_decal/trimline/purple/corner{
	dir = 1
	},
/mob/living/simple_animal/slime,
/turf/open/floor/iron/white,
/area/shuttle/prison_shuttle)
"H" = (
/obj/effect/turf_decal/trimline/purple/filled/line{
	dir = 6
	},
/obj/effect/turf_decal/trimline/purple/corner{
	dir = 1
	},
/obj/machinery/light/directional/east,
/turf/open/floor/iron/white,
/area/shuttle/prison_shuttle)
"J" = (
/obj/effect/turf_decal/trimline/purple/filled/line,
/turf/open/floor/iron/white,
/area/shuttle/prison_shuttle)
"K" = (
/obj/effect/spawner/structure/window/reinforced,
/turf/open/floor/plating,
/area/shuttle/prison_shuttle)
"L" = (
/obj/effect/turf_decal/trimline/purple/filled/line{
	dir = 5
	},
/obj/effect/turf_decal/trimline/purple/corner{
	dir = 8
	},
/obj/machinery/atmospherics/components/unary/passive_vent{
	dir = 1
	},
/turf/open/floor/circuit/telecomms,
/area/shuttle/prison_shuttle)
"N" = (
/obj/machinery/atmospherics/components/binary/thermomachine/freezer/on{
	dir = 1
	},
/obj/effect/turf_decal/trimline/purple/filled/end,
/turf/open/floor/iron/white,
/area/shuttle/prison_shuttle)
"O" = (
/obj/machinery/smartfridge/prison/xenobiology,
/turf/closed/wall/mineral/titanium,
/area/shuttle/prison_shuttle)
"P" = (
/obj/effect/turf_decal/trimline/purple/filled/line{
	dir = 10
	},
/obj/effect/turf_decal/trimline/purple/corner{
	dir = 4
	},
/obj/machinery/camera/directional/west{
	c_tag = "Prison Xenobiology North";
	name = "Xenobiology Camera"
	},
/turf/open/floor/iron/white,
/area/shuttle/prison_shuttle)
"R" = (
/obj/machinery/monkey_recycler,
/obj/effect/turf_decal/trimline/purple/filled/line{
	dir = 10
	},
/turf/open/floor/iron/white,
/area/shuttle/prison_shuttle)
"T" = (
/obj/effect/turf_decal/trimline/purple/filled/line,
/obj/effect/turf_decal/trimline/purple/filled/corner{
	dir = 4
	},
/turf/open/floor/iron/white,
/area/shuttle/prison_shuttle)
"U" = (
/obj/effect/turf_decal/trimline/purple/filled/line{
	dir = 1
	},
/obj/effect/turf_decal/trimline/purple/filled/corner,
/turf/open/floor/iron/white,
/area/shuttle/prison_shuttle)
"V" = (
/obj/effect/turf_decal/trimline/purple/filled/line{
	dir = 1
	},
/turf/open/floor/iron/white,
/area/shuttle/prison_shuttle)
"X" = (
/obj/effect/turf_decal/trimline/purple/filled/line,
/obj/machinery/atmospherics/pipe/smart/simple/general/visible{
	dir = 6
	},
/turf/open/floor/iron/white,
/area/shuttle/prison_shuttle)

(1,1,1) = {"
b
b
b
b
b
b
b
b
b
b
b
s
"}
(2,1,1) = {"
b
e
P
K
n
x
R
K
r
k
b
t
"}
(3,1,1) = {"
b
f
F
K
V
a
X
z
L
D
q
u
"}
(4,1,1) = {"
b
w
K
K
V
c
C
N
K
K
q
u
"}
(5,1,1) = {"
b
e
l
K
V
c
J
K
e
l
q
u
"}
(6,1,1) = {"
b
f
H
K
U
h
T
K
p
j
b
v
"}
(7,1,1) = {"
b
b
b
b
g
O
i
b
b
b
b
s
"}
