//MAP CONVERTED BY dmm2tgm.py THIS HEADER COMMENT PREVENTS RECONVERSION, DO NOT REMOVE
"b" = (
/turf/closed/wall/mineral/titanium,
/area/shuttle/prison_shuttle)
"c" = (
/obj/structure/table/reinforced,
/obj/item/skillchip/job/chef,
/obj/item/book/manual/chef_recipes,
/obj/item/reagent_containers/glass/bowl,
/obj/item/reagent_containers/glass/bowl,
/obj/item/reagent_containers/glass/bowl,
/obj/effect/turf_decal/siding/wood,
/turf/open/floor/wood/large,
/area/shuttle/prison_shuttle)
"d" = (
/obj/structure/table/reinforced,
/obj/item/storage/bag/tray/cafeteria,
/obj/item/storage/bag/tray/cafeteria,
/obj/item/storage/bag/tray/cafeteria,
/obj/item/storage/bag/tray/cafeteria,
/obj/item/storage/bag/tray/cafeteria,
/obj/item/storage/bag/tray/cafeteria,
/obj/item/reagent_containers/glass/beaker/cryoxadone{
	pixel_x = 6;
	pixel_y = 10
	},
/obj/effect/turf_decal/siding/wood,
/turf/open/floor/wood/large,
/area/shuttle/prison_shuttle)
"f" = (
/obj/structure/closet/secure_closet/freezer/gulag_fridge,
/obj/effect/turf_decal/delivery/white{
	color = "#52B4E9"
	},
/turf/open/floor/wood/large,
/area/shuttle/prison_shuttle)
"g" = (
/obj/machinery/door/airlock/titanium{
	name = "Prison Ship Airlock"
	},
/turf/open/floor/iron/textured_large,
/area/shuttle/prison_shuttle)
"h" = (
/obj/machinery/light/directional/east,
/turf/open/floor/iron/textured_large,
/area/shuttle/prison_shuttle)
"i" = (
/obj/docking_port/mobile/prison,
/obj/machinery/door/airlock/titanium{
	name = "Prison Ship Airlock"
	},
/turf/open/floor/iron/textured_large,
/area/shuttle/prison_shuttle)
"j" = (
/obj/structure/table/reinforced,
/obj/item/kitchen/fork/plastic,
/obj/item/kitchen/fork/plastic,
/obj/item/kitchen/fork/plastic,
/obj/item/knife/plastic,
/obj/item/knife/plastic,
/obj/item/knife/plastic,
/obj/item/kitchen/spoon/plastic,
/obj/item/kitchen/spoon/plastic,
/obj/item/kitchen/spoon/plastic,
/obj/effect/turf_decal/siding/wood,
/turf/open/floor/wood/large,
/area/shuttle/prison_shuttle)
"k" = (
/obj/machinery/light/directional/west,
/obj/structure/table/reinforced,
/obj/machinery/microwave,
/turf/open/floor/iron/cafeteria,
/area/shuttle/prison_shuttle)
"l" = (
/obj/structure/chair/stool/bar/directional/south,
/turf/open/floor/iron/textured_large,
/area/shuttle/prison_shuttle)
"m" = (
/obj/machinery/light/directional/south,
/turf/open/floor/iron/cafeteria,
/area/shuttle/prison_shuttle)
"n" = (
/obj/structure/table/reinforced,
/turf/open/floor/iron/cafeteria,
/area/shuttle/prison_shuttle)
"q" = (
/obj/structure/window/reinforced{
	dir = 1
	},
/obj/structure/shuttle/engine/heater,
/turf/open/floor/plating/airless,
/area/shuttle/prison_shuttle)
"s" = (
/turf/template_noop,
/area/template_noop)
"t" = (
/obj/structure/shuttle/engine/propulsion/burst/left,
/turf/open/floor/plating/airless,
/area/shuttle/prison_shuttle)
"u" = (
/obj/structure/shuttle/engine/propulsion,
/turf/open/floor/plating/airless,
/area/shuttle/prison_shuttle)
"v" = (
/obj/structure/shuttle/engine/propulsion/burst/right,
/turf/open/floor/plating/airless,
/area/shuttle/prison_shuttle)
"w" = (
/obj/effect/turf_decal/siding/wood,
/turf/open/floor/wood/large,
/area/shuttle/prison_shuttle)
"x" = (
/obj/item/radio/intercom/prison/directional/east,
/turf/open/floor/iron/cafeteria,
/area/shuttle/prison_shuttle)
"y" = (
/turf/open/floor/wood/large,
/area/shuttle/prison_shuttle)
"z" = (
/obj/machinery/oven,
/turf/open/floor/iron/cafeteria,
/area/shuttle/prison_shuttle)
"F" = (
/obj/structure/closet/secure_closet/freezer/fridge/open,
/obj/effect/turf_decal/delivery/white{
	color = "#52B4E9"
	},
/turf/open/floor/wood/large,
/area/shuttle/prison_shuttle)
"I" = (
/turf/open/floor/iron/cafeteria,
/area/shuttle/prison_shuttle)
"K" = (
/obj/machinery/smartfridge/prison/kitchen,
/turf/closed/wall/mineral/titanium,
/area/shuttle/prison_shuttle)
"L" = (
/obj/machinery/processor,
/turf/open/floor/iron/cafeteria,
/area/shuttle/prison_shuttle)
"M" = (
/obj/effect/turf_decal/siding/wood/corner{
	dir = 8
	},
/turf/open/floor/wood/large,
/area/shuttle/prison_shuttle)
"P" = (
/obj/machinery/griddle,
/turf/open/floor/iron/cafeteria,
/area/shuttle/prison_shuttle)
"Q" = (
/obj/structure/closet/secure_closet/freezer/meat/open,
/obj/effect/turf_decal/delivery/white{
	color = "#52B4E9"
	},
/turf/open/floor/wood/large,
/area/shuttle/prison_shuttle)
"R" = (
/obj/machinery/deepfryer,
/turf/open/floor/iron/cafeteria,
/area/shuttle/prison_shuttle)
"U" = (
/obj/structure/table/reinforced,
/obj/item/reagent_containers/food/condiment/enzyme{
	pixel_x = 10;
	pixel_y = 5
	},
/obj/item/reagent_containers/food/condiment/peppermill{
	desc = "Often used to flavor food or make people sneeze. Fashionably moved to the left side of the table.";
	pixel_x = -8;
	pixel_y = 2
	},
/obj/item/reagent_containers/food/condiment/saltshaker{
	layer = 3.1;
	pixel_x = -2;
	pixel_y = 2
	},
/obj/item/kitchen/rollingpin,
/obj/effect/turf_decal/siding/wood{
	dir = 10
	},
/turf/open/floor/wood/large,
/area/shuttle/prison_shuttle)
"V" = (
/turf/open/floor/iron/textured_large,
/area/shuttle/prison_shuttle)
"W" = (
/obj/machinery/light/directional/west,
/turf/open/floor/iron/textured_large,
/area/shuttle/prison_shuttle)
"X" = (
/obj/structure/closet/secure_closet/freezer/kitchen,
/obj/machinery/light/directional/north,
/obj/effect/turf_decal/delivery/white{
	color = "#52B4E9"
	},
/turf/open/floor/wood/large,
/area/shuttle/prison_shuttle)
"Y" = (
/obj/machinery/vending/dinnerware,
/turf/open/floor/wood/large,
/area/shuttle/prison_shuttle)

(1,1,1) = {"
b
b
b
b
b
b
b
b
b
b
b
s
"}
(2,1,1) = {"
b
Y
w
W
V
l
n
k
P
P
b
t
"}
(3,1,1) = {"
b
f
M
U
V
l
n
I
I
I
q
u
"}
(4,1,1) = {"
b
X
y
c
V
l
n
I
I
m
q
u
"}
(5,1,1) = {"
b
F
y
j
V
l
n
z
I
R
q
u
"}
(6,1,1) = {"
b
Q
y
d
V
h
V
x
I
L
b
v
"}
(7,1,1) = {"
b
b
b
b
g
K
i
b
b
b
b
s
"}
