//MAP CONVERTED BY dmm2tgm.py THIS HEADER COMMENT PREVENTS RECONVERSION, DO NOT REMOVE
"a" = (
/turf/closed/wall/r_wall,
/area/centcom/devil_holding_cell)
"r" = (
/obj/effect/landmark/devil_cell,
/turf/open/floor/iron,
/area/centcom/devil_holding_cell)

(1,1,1) = {"
a
a
a
"}
(2,1,1) = {"
a
r
a
"}
(3,1,1) = {"
a
a
a
"}
