//MAP CONVERTED BY dmm2tgm.py THIS HEADER COMMENT PREVENTS RECONVERSION, DO NOT REMOVE
"a" = (
/obj/structure/shuttle/engine/propulsion/burst/left,
/obj/effect/turf_decal/stripes/line,
/turf/open/floor/plating/airless,
/area/shuttle/supply)
"c" = (
/obj/machinery/conveyor{
	dir = 8;
	id = "cargoshuttle";
	name = "cargo shuttle conveyor belt"
	},
/obj/effect/decal/cleanable/dirt,
/obj/structure/railing{
	layer = 3.1;
	pixel_y = -5
	},
/turf/open/floor/mineral/titanium,
/area/shuttle/supply)
"d" = (
/obj/effect/decal/cleanable/dirt,
/obj/machinery/light/directional/west,
/obj/structure/railing{
	dir = 8;
	pixel_x = -3
	},
/obj/effect/decal/cleanable/dirt/dust,
/obj/effect/turf_decal/trimline/blue/arrow_cw{
	dir = 8
	},
/turf/open/floor/mineral/titanium/blue,
/area/shuttle/supply)
"g" = (
/obj/effect/decal/cleanable/dirt,
/obj/effect/decal/cleanable/dirt/dust,
/obj/effect/turf_decal/trimline/blue/arrow_cw,
/turf/open/floor/mineral/titanium/purple,
/area/shuttle/supply)
"h" = (
/obj/effect/decal/cleanable/dirt,
/obj/effect/decal/cleanable/dirt/dust,
/obj/effect/turf_decal/stripes/white/line{
	dir = 4
	},
/turf/open/floor/mineral/titanium/purple,
/area/shuttle/supply)
"i" = (
/obj/effect/decal/cleanable/dirt,
/obj/machinery/light/directional/west,
/obj/structure/railing{
	dir = 8;
	pixel_x = -3
	},
/obj/effect/turf_decal/stripes/white/line{
	dir = 1
	},
/obj/effect/decal/cleanable/dirt/dust,
/turf/open/floor/mineral/titanium/purple,
/area/shuttle/supply)
"j" = (
/obj/machinery/conveyor{
	dir = 8;
	id = "cargoshuttle";
	name = "cargo shuttle conveyor belt"
	},
/obj/structure/railing{
	layer = 3.1;
	pixel_y = -5
	},
/turf/open/floor/mineral/titanium,
/area/shuttle/supply)
"k" = (
/obj/machinery/conveyor{
	dir = 4;
	id = "cargoshuttle";
	name = "cargo shuttle conveyor belt"
	},
/obj/effect/decal/cleanable/dirt,
/obj/structure/railing{
	dir = 1;
	layer = 3.1;
	pixel_y = 5
	},
/obj/effect/decal/cleanable/dirt/dust,
/obj/effect/decal/cleanable/dirt/dust,
/turf/open/floor/mineral/titanium,
/area/shuttle/supply)
"l" = (
/obj/machinery/conveyor{
	dir = 4;
	id = "cargoshuttle";
	name = "cargo shuttle conveyor belt"
	},
/obj/effect/decal/cleanable/dirt,
/obj/structure/railing{
	dir = 1;
	layer = 3.1;
	pixel_y = 5
	},
/turf/open/floor/mineral/titanium,
/area/shuttle/supply)
"m" = (
/obj/effect/decal/cleanable/dirt/dust,
/turf/open/floor/mineral/titanium/blue,
/area/shuttle/supply)
"n" = (
/obj/effect/decal/cleanable/dirt,
/obj/effect/decal/cleanable/dirt/dust,
/obj/effect/decal/cleanable/dirt/dust,
/obj/effect/decal/cleanable/glass,
/obj/effect/turf_decal/stripes/white/line{
	dir = 4
	},
/obj/effect/turf_decal/stripes/white/line{
	dir = 1
	},
/turf/open/floor/mineral/titanium,
/area/shuttle/supply)
"o" = (
/obj/structure/shuttle/engine/propulsion/burst/right,
/obj/effect/turf_decal/stripes/line,
/turf/open/floor/plating/airless,
/area/shuttle/supply)
"p" = (
/obj/machinery/conveyor{
	dir = 4;
	id = "cargoshuttle";
	name = "cargo shuttle conveyor belt"
	},
/obj/effect/decal/cleanable/dirt,
/obj/effect/decal/cleanable/dirt/dust,
/turf/open/floor/mineral/titanium,
/area/shuttle/supply)
"q" = (
/obj/effect/decal/cleanable/dirt,
/obj/effect/decal/cleanable/dirt/dust,
/turf/open/floor/mineral/titanium/blue,
/area/shuttle/supply)
"r" = (
/obj/machinery/conveyor{
	id = "cargoshuttle";
	name = "cargo shuttle conveyor belt"
	},
/obj/structure/railing{
	dir = 1;
	layer = 3.1;
	pixel_y = 5
	},
/obj/effect/decal/cleanable/dirt/dust,
/obj/effect/decal/cleanable/dirt/dust,
/turf/open/floor/mineral/titanium,
/area/shuttle/supply)
"s" = (
/obj/effect/decal/cleanable/dirt,
/obj/structure/railing{
	dir = 8;
	pixel_x = -3
	},
/obj/effect/decal/cleanable/dirt/dust,
/obj/effect/turf_decal/trimline/blue/arrow_cw{
	dir = 10
	},
/turf/open/floor/mineral/titanium,
/area/shuttle/supply)
"u" = (
/obj/machinery/conveyor{
	dir = 4;
	id = "cargoshuttle";
	name = "cargo shuttle conveyor belt"
	},
/obj/structure/plasticflaps/opaque,
/turf/open/floor/mineral/titanium,
/area/shuttle/supply)
"v" = (
/obj/effect/decal/cleanable/dirt,
/obj/effect/turf_decal/stripes/white/line{
	dir = 1
	},
/turf/open/floor/mineral/titanium/purple,
/area/shuttle/supply)
"w" = (
/obj/machinery/door/airlock/titanium{
	name = "Supply Shuttle Airlock";
	req_access_txt = "31"
	},
/obj/effect/decal/cleanable/dirt/dust,
/turf/open/floor/mineral/titanium,
/area/shuttle/supply)
"y" = (
/obj/effect/spawner/structure/window/reinforced/shuttle,
/turf/open/floor/plating,
/area/shuttle/supply)
"A" = (
/obj/structure/railing{
	dir = 8;
	pixel_x = -3
	},
/obj/effect/decal/cleanable/dirt/dust,
/turf/open/floor/mineral/titanium/purple,
/area/shuttle/supply)
"B" = (
/obj/machinery/conveyor{
	dir = 4;
	id = "cargoshuttle";
	name = "cargo shuttle conveyor belt"
	},
/obj/structure/railing{
	dir = 1;
	layer = 3.1;
	pixel_y = 5
	},
/obj/effect/decal/cleanable/dirt/dust,
/turf/open/floor/mineral/titanium,
/area/shuttle/supply)
"C" = (
/obj/structure/window/reinforced{
	dir = 1
	},
/obj/structure/shuttle/engine/heater,
/obj/effect/decal/cleanable/dirt,
/obj/effect/turf_decal/stripes/line,
/turf/open/floor/plating/airless,
/area/shuttle/supply)
"D" = (
/obj/machinery/door/airlock/titanium{
	name = "Supply Shuttle Airlock";
	req_access_txt = "31"
	},
/obj/effect/decal/cleanable/dirt/dust,
/obj/docking_port/mobile/supply{
	height = 6
	},
/turf/open/floor/mineral/titanium,
/area/shuttle/supply)
"F" = (
/obj/effect/decal/cleanable/dirt,
/obj/effect/decal/cleanable/dirt,
/turf/open/floor/mineral/titanium/blue,
/area/shuttle/supply)
"G" = (
/obj/machinery/conveyor_switch/oneway{
	id = "cargoshuttle"
	},
/obj/effect/turf_decal/trimline/blue,
/obj/machinery/light/directional/east,
/turf/open/floor/mineral/titanium/yellow,
/area/shuttle/supply)
"H" = (
/obj/effect/decal/cleanable/generic,
/obj/effect/decal/cleanable/dirt,
/turf/open/floor/mineral/titanium,
/area/shuttle/supply)
"I" = (
/obj/effect/decal/cleanable/dirt,
/obj/effect/decal/cleanable/dirt/dust,
/obj/effect/turf_decal/stripes/white/line{
	dir = 4
	},
/turf/open/floor/mineral/titanium,
/area/shuttle/supply)
"J" = (
/obj/machinery/conveyor{
	id = "cargoshuttle";
	name = "cargo shuttle conveyor belt"
	},
/obj/effect/decal/cleanable/dirt/dust,
/obj/effect/decal/cleanable/dirt/dust,
/turf/open/floor/mineral/titanium,
/area/shuttle/supply)
"K" = (
/obj/machinery/conveyor{
	id = "cargoshuttle";
	name = "cargo shuttle conveyor belt"
	},
/obj/effect/decal/cleanable/dirt,
/turf/open/floor/mineral/titanium,
/area/shuttle/supply)
"L" = (
/obj/effect/decal/cleanable/dirt,
/obj/effect/turf_decal/trimline/blue/arrow_cw{
	dir = 1
	},
/turf/open/floor/mineral/titanium/blue,
/area/shuttle/supply)
"M" = (
/obj/effect/decal/cleanable/dirt/dust,
/turf/open/floor/mineral/titanium/purple,
/area/shuttle/supply)
"N" = (
/obj/machinery/conveyor{
	dir = 8;
	id = "cargoshuttle";
	name = "cargo shuttle conveyor belt"
	},
/obj/effect/decal/cleanable/dirt,
/obj/structure/plasticflaps/opaque,
/turf/open/floor/mineral/titanium,
/area/shuttle/supply)
"O" = (
/obj/effect/decal/cleanable/dirt,
/obj/effect/decal/cleanable/dirt,
/obj/effect/decal/cleanable/generic,
/obj/effect/turf_decal/stripes/white/line,
/obj/effect/turf_decal/trimline/blue/arrow_cw,
/turf/open/floor/mineral/titanium,
/area/shuttle/supply)
"P" = (
/obj/effect/decal/cleanable/glass,
/obj/effect/turf_decal/trimline/blue/arrow_cw{
	dir = 1
	},
/turf/open/floor/mineral/titanium/blue,
/area/shuttle/supply)
"Q" = (
/turf/closed/wall/mineral/titanium,
/area/shuttle/supply)
"R" = (
/obj/structure/window/reinforced{
	dir = 1
	},
/obj/structure/shuttle/engine/heater,
/obj/effect/turf_decal/stripes/line,
/turf/open/floor/plating/airless,
/area/shuttle/supply)
"S" = (
/obj/structure/railing{
	dir = 8;
	pixel_x = -3
	},
/obj/effect/decal/cleanable/generic,
/turf/open/floor/mineral/titanium,
/area/shuttle/supply)
"T" = (
/obj/structure/shuttle/engine/propulsion,
/obj/effect/turf_decal/stripes/line,
/turf/open/floor/plating/airless,
/area/shuttle/supply)
"U" = (
/obj/effect/decal/cleanable/dirt,
/turf/open/floor/mineral/titanium,
/area/shuttle/supply)
"V" = (
/obj/effect/decal/cleanable/dirt,
/obj/effect/decal/cleanable/dirt,
/obj/effect/decal/cleanable/dirt,
/obj/effect/turf_decal/trimline/blue/arrow_cw,
/turf/open/floor/mineral/titanium,
/area/shuttle/supply)
"W" = (
/obj/effect/decal/cleanable/dirt/dust,
/obj/effect/decal/cleanable/dirt/dust,
/obj/effect/decal/cleanable/dirt/dust,
/turf/open/floor/mineral/titanium/purple,
/area/shuttle/supply)
"X" = (
/obj/effect/decal/cleanable/dirt,
/obj/effect/decal/cleanable/dirt,
/obj/effect/decal/cleanable/dirt,
/obj/effect/decal/cleanable/dirt,
/obj/effect/turf_decal/stripes/white/line{
	dir = 1
	},
/obj/effect/turf_decal/trimline/blue/arrow_cw{
	dir = 1
	},
/obj/effect/turf_decal/trimline/blue,
/turf/open/floor/mineral/titanium/yellow,
/area/shuttle/supply)
"Y" = (
/obj/effect/decal/cleanable/dirt/dust,
/obj/effect/decal/cleanable/dirt/dust,
/obj/effect/turf_decal/stripes/white/line{
	dir = 1
	},
/turf/open/floor/mineral/titanium,
/area/shuttle/supply)
"Z" = (
/obj/structure/railing{
	dir = 8;
	pixel_x = -3
	},
/obj/effect/turf_decal/trimline/blue/arrow_cw{
	dir = 9
	},
/obj/effect/decal/cleanable/glass,
/turf/open/floor/mineral/titanium/blue,
/area/shuttle/supply)

(1,1,1) = {"
Q
Q
Q
Q
Q
Q
Q
Q
Q
Q
a
"}
(2,1,1) = {"
Q
l
i
S
Z
d
s
A
c
R
T
"}
(3,1,1) = {"
Q
l
v
H
P
q
V
M
c
R
T
"}
(4,1,1) = {"
Q
B
Y
W
L
F
g
U
c
R
T
"}
(5,1,1) = {"
Q
k
n
h
L
m
g
I
j
C
T
"}
(6,1,1) = {"
Q
r
J
p
X
G
O
K
c
C
T
"}
(7,1,1) = {"
Q
Q
Q
u
w
y
D
N
Q
Q
o
"}
