//MAP CONVERTED BY dmm2tgm.py THIS HEADER COMMENT PREVENTS RECONVERSION, DO NOT REMOVE
"cd" = (
/turf/closed/wall/mineral/plastitanium,
/area/space)
"cw" = (
/obj/structure/railing{
	dir = 4;
	layer = 3.1;
	pixel_x = 5
	},
/obj/effect/turf_decal/trimline/red/corner{
	dir = 8
	},
/obj/effect/turf_decal/trimline/red/arrow_cw{
	dir = 5
	},
/turf/open/floor/pod/dark,
/area/space)
"cX" = (
/obj/effect/turf_decal/stripes/red/line,
/obj/machinery/holopad,
/turf/open/floor/pod/light,
/area/space)
"en" = (
/obj/structure/railing{
	dir = 4;
	layer = 3.1;
	pixel_x = 5
	},
/obj/effect/turf_decal/trimline/red/arrow_ccw{
	dir = 6
	},
/obj/effect/turf_decal/trimline/red/corner{
	dir = 1
	},
/turf/open/floor/pod/dark,
/area/space)
"eU" = (
/obj/structure/closet/wardrobe/black,
/turf/open/floor/pod/dark,
/area/space)
"fD" = (
/obj/structure/closet/wardrobe/yellow,
/turf/open/floor/pod/dark,
/area/space)
"hN" = (
/obj/effect/turf_decal/tile/blue,
/obj/effect/turf_decal/tile/blue{
	dir = 8
	},
/turf/open/floor/pod/light,
/area/space)
"ic" = (
/obj/docking_port/mobile/arrivals{
	dir = 2;
	dwidth = 4;
	height = 17;
	name = "solitaire arrivals shuttle";
	width = 9
	},
/turf/closed/wall/mineral/plastitanium,
/area/space)
"iP" = (
/obj/machinery/status_display/evac,
/turf/closed/wall/mineral/plastitanium,
/area/space)
"jy" = (
/obj/structure/closet/wardrobe/grey,
/turf/open/floor/pod/dark,
/area/space)
"jF" = (
/obj/effect/spawner/structure/window/reinforced/plasma/plastitanium,
/turf/open/floor/plating,
/area/space)
"kl" = (
/obj/effect/turf_decal/tile/neutral,
/obj/effect/turf_decal/tile/neutral{
	dir = 4
	},
/obj/effect/turf_decal/stripes/red/line{
	dir = 1
	},
/turf/open/floor/pod/light,
/area/space)
"kV" = (
/obj/effect/turf_decal/bot_red,
/obj/structure/railing{
	dir = 1;
	layer = 3.1;
	pixel_y = 5
	},
/obj/structure/chair/comfy/shuttle,
/obj/effect/turf_decal/trimline/red,
/turf/open/floor/pod/dark,
/area/space)
"np" = (
/obj/effect/turf_decal/delivery,
/obj/structure/closet/wardrobe/mixed,
/obj/structure/railing{
	dir = 1;
	layer = 3.1;
	pixel_y = 5
	},
/turf/open/floor/pod/dark,
/area/space)
"nw" = (
/obj/item/clothing/suit/hazardvest{
	desc = "A high-visibility lifejacket complete with whistle and slot for oxygen tanks.";
	name = "emergency lifejacket"
	},
/obj/item/clothing/suit/hazardvest{
	desc = "A high-visibility lifejacket complete with whistle and slot for oxygen tanks.";
	name = "emergency lifejacket"
	},
/obj/item/clothing/suit/hazardvest{
	desc = "A high-visibility lifejacket complete with whistle and slot for oxygen tanks.";
	name = "emergency lifejacket"
	},
/obj/item/clothing/suit/hazardvest{
	desc = "A high-visibility lifejacket complete with whistle and slot for oxygen tanks.";
	name = "emergency lifejacket"
	},
/obj/item/clothing/suit/hazardvest{
	desc = "A high-visibility lifejacket complete with whistle and slot for oxygen tanks.";
	name = "emergency lifejacket"
	},
/obj/item/tank/internals/emergency_oxygen{
	pixel_x = 3
	},
/obj/item/tank/internals/emergency_oxygen{
	pixel_x = 3
	},
/obj/item/tank/internals/emergency_oxygen{
	pixel_x = 3
	},
/obj/item/tank/internals/emergency_oxygen{
	pixel_x = 3
	},
/obj/item/tank/internals/emergency_oxygen{
	pixel_x = 3
	},
/obj/item/clothing/mask/breath{
	pixel_x = -3;
	pixel_y = -3
	},
/obj/item/clothing/mask/breath{
	pixel_x = -3;
	pixel_y = -3
	},
/obj/item/clothing/mask/breath{
	pixel_x = -3;
	pixel_y = -3
	},
/obj/item/clothing/mask/breath{
	pixel_x = -3;
	pixel_y = -3
	},
/obj/item/clothing/mask/breath{
	pixel_x = -3;
	pixel_y = -3
	},
/obj/item/clothing/head/hardhat/orange{
	name = "protective hat";
	pixel_y = 9
	},
/obj/item/clothing/head/hardhat/orange{
	name = "protective hat";
	pixel_y = 9
	},
/obj/item/clothing/head/hardhat/orange{
	name = "protective hat";
	pixel_y = 9
	},
/obj/item/clothing/head/hardhat/orange{
	name = "protective hat";
	pixel_y = 9
	},
/obj/item/clothing/head/hardhat/orange{
	name = "protective hat";
	pixel_y = 9
	},
/obj/structure/closet/crate/internals,
/obj/effect/turf_decal/bot,
/obj/structure/railing{
	dir = 1;
	layer = 3.1;
	pixel_y = 5
	},
/obj/machinery/light/red/directional/west,
/turf/open/floor/pod/dark,
/area/space)
"oi" = (
/obj/item/storage/briefcase{
	pixel_x = 3;
	pixel_y = 3
	},
/obj/item/storage/secure/briefcase,
/obj/effect/turf_decal/bot,
/obj/structure/table/reinforced/plastitaniumglass,
/obj/machinery/light/red/directional/east,
/turf/open/floor/pod/dark,
/area/space)
"oL" = (
/obj/structure/railing{
	dir = 1;
	layer = 3.1;
	pixel_y = 5
	},
/turf/open/floor/pod/dark,
/area/space)
"pp" = (
/obj/effect/turf_decal/trimline/red/arrow_ccw{
	dir = 6
	},
/obj/effect/turf_decal/trimline/red/arrow_cw{
	dir = 10
	},
/obj/machinery/light/floor,
/turf/open/floor/pod/dark,
/area/space)
"py" = (
/obj/effect/turf_decal/trimline/red/arrow_ccw{
	dir = 8
	},
/obj/effect/turf_decal/trimline/red/arrow_cw{
	dir = 4
	},
/turf/open/floor/pod/dark,
/area/space)
"pT" = (
/obj/effect/turf_decal/tile/neutral,
/obj/effect/turf_decal/tile/neutral{
	dir = 4
	},
/obj/effect/turf_decal/stripes/red/line,
/turf/open/floor/pod/light,
/area/space)
"qh" = (
/obj/structure/chair/comfy/shuttle{
	dir = 8
	},
/obj/effect/turf_decal/trimline/blue,
/obj/structure/railing{
	dir = 1;
	layer = 3.1;
	pixel_y = 5
	},
/turf/open/floor/pod/dark,
/area/space)
"rg" = (
/obj/effect/turf_decal/tile/neutral{
	dir = 1
	},
/obj/effect/turf_decal/tile/neutral{
	dir = 8
	},
/obj/effect/turf_decal/stripes/red/line,
/obj/effect/turf_decal/loading_area/red{
	dir = 8
	},
/turf/open/floor/pod/light,
/area/space)
"tn" = (
/obj/effect/turf_decal/trimline/red/arrow_cw{
	dir = 10
	},
/obj/structure/railing{
	dir = 8;
	pixel_x = -3
	},
/obj/effect/turf_decal/trimline/red/corner{
	dir = 4
	},
/turf/open/floor/pod/dark,
/area/space)
"wy" = (
/obj/effect/turf_decal/trimline/red/arrow_ccw{
	dir = 8
	},
/obj/effect/turf_decal/trimline/red/arrow_cw{
	dir = 4
	},
/obj/structure/railing{
	dir = 8;
	pixel_x = -3
	},
/obj/machinery/light/red/directional/west,
/turf/open/floor/pod/dark,
/area/space)
"xa" = (
/obj/effect/turf_decal/trimline/red/arrow_ccw{
	dir = 4
	},
/obj/effect/turf_decal/trimline/red/arrow_cw{
	dir = 8
	},
/obj/structure/railing{
	dir = 4;
	layer = 3.1;
	pixel_x = 5
	},
/turf/open/floor/pod/dark,
/area/space)
"xR" = (
/obj/effect/turf_decal/tile/blue{
	dir = 8
	},
/turf/open/floor/pod/dark,
/area/space)
"AY" = (
/obj/machinery/light/small/directional/north,
/obj/effect/turf_decal/tile/blue{
	dir = 1
	},
/obj/effect/turf_decal/tile/blue{
	dir = 8
	},
/obj/structure/railing{
	dir = 1;
	layer = 3.1;
	pixel_y = 5
	},
/turf/open/floor/pod/light,
/area/space)
"Br" = (
/obj/machinery/cell_charger,
/obj/effect/turf_decal/bot,
/obj/structure/table/reinforced/plastitaniumglass,
/obj/structure/railing{
	dir = 1;
	layer = 3.1;
	pixel_y = 5
	},
/turf/open/floor/pod/dark,
/area/space)
"BU" = (
/obj/effect/turf_decal/stripes/red/line{
	dir = 1
	},
/obj/machinery/holopad,
/turf/open/floor/pod/light,
/area/space)
"Ca" = (
/obj/machinery/computer{
	dir = 1;
	name = "Shuttle computer"
	},
/obj/effect/turf_decal/tile/blue{
	dir = 1
	},
/obj/effect/turf_decal/tile/blue,
/obj/effect/turf_decal/tile/blue{
	dir = 4
	},
/obj/effect/turf_decal/tile/blue{
	dir = 8
	},
/turf/open/floor/pod/light,
/area/space)
"Cf" = (
/turf/closed/wall/mineral/plastitanium/nodiagonal,
/area/space)
"Cj" = (
/obj/effect/turf_decal/trimline/red/arrow_ccw{
	dir = 8
	},
/obj/effect/turf_decal/trimline/red/arrow_cw{
	dir = 4
	},
/obj/structure/railing{
	dir = 4;
	layer = 3.1;
	pixel_x = 5
	},
/obj/machinery/light/red/directional/east,
/turf/open/floor/pod/dark,
/area/space)
"Dk" = (
/obj/effect/turf_decal/stripes/red/line{
	dir = 1
	},
/obj/machinery/vending/wallmed/directional/north{
	use_power = 0
	},
/turf/open/floor/pod/light,
/area/space)
"Dl" = (
/obj/structure/sign/nanotrasen,
/turf/closed/wall/mineral/plastitanium,
/area/space)
"DL" = (
/obj/effect/turf_decal/tile/blue{
	dir = 1
	},
/obj/effect/turf_decal/tile/blue{
	dir = 4
	},
/obj/structure/chair/comfy/shuttle,
/obj/effect/turf_decal/trimline/blue,
/obj/effect/turf_decal/trimline/blue,
/turf/open/floor/pod/light,
/area/space)
"DS" = (
/turf/template_noop,
/area/space)
"GN" = (
/obj/machinery/requests_console{
	department = "Arrival shuttle";
	name = "Arrivals Shuttle console"
	},
/turf/closed/wall/mineral/plastitanium/nodiagonal,
/area/space)
"Hm" = (
/obj/item/storage/toolbox/emergency,
/obj/effect/turf_decal/bot,
/obj/structure/table/reinforced/plastitaniumglass,
/obj/structure/railing{
	dir = 1;
	layer = 3.1;
	pixel_y = 5
	},
/turf/open/floor/pod/dark,
/area/space)
"Ir" = (
/obj/item/paper_bin,
/obj/item/pen,
/obj/effect/turf_decal/bot,
/obj/item/radio/intercom/directional/west,
/obj/structure/table/reinforced/plastitaniumglass,
/obj/machinery/light/red/directional/west,
/turf/open/floor/pod/dark,
/area/space)
"Ka" = (
/obj/item/clothing/suit/hazardvest{
	desc = "A high-visibility lifejacket complete with whistle and slot for oxygen tanks.";
	name = "emergency lifejacket"
	},
/obj/item/clothing/suit/hazardvest{
	desc = "A high-visibility lifejacket complete with whistle and slot for oxygen tanks.";
	name = "emergency lifejacket"
	},
/obj/item/clothing/suit/hazardvest{
	desc = "A high-visibility lifejacket complete with whistle and slot for oxygen tanks.";
	name = "emergency lifejacket"
	},
/obj/item/clothing/suit/hazardvest{
	desc = "A high-visibility lifejacket complete with whistle and slot for oxygen tanks.";
	name = "emergency lifejacket"
	},
/obj/item/clothing/suit/hazardvest{
	desc = "A high-visibility lifejacket complete with whistle and slot for oxygen tanks.";
	name = "emergency lifejacket"
	},
/obj/item/tank/internals/emergency_oxygen{
	pixel_x = 3
	},
/obj/item/tank/internals/emergency_oxygen{
	pixel_x = 3
	},
/obj/item/tank/internals/emergency_oxygen{
	pixel_x = 3
	},
/obj/item/tank/internals/emergency_oxygen{
	pixel_x = 3
	},
/obj/item/tank/internals/emergency_oxygen{
	pixel_x = 3
	},
/obj/item/clothing/mask/breath{
	pixel_x = -3;
	pixel_y = -3
	},
/obj/item/clothing/mask/breath{
	pixel_x = -3;
	pixel_y = -3
	},
/obj/item/clothing/mask/breath{
	pixel_x = -3;
	pixel_y = -3
	},
/obj/item/clothing/mask/breath{
	pixel_x = -3;
	pixel_y = -3
	},
/obj/item/clothing/mask/breath{
	pixel_x = -3;
	pixel_y = -3
	},
/obj/item/clothing/head/hardhat/orange{
	name = "protective hat";
	pixel_y = 9
	},
/obj/item/clothing/head/hardhat/orange{
	name = "protective hat";
	pixel_y = 9
	},
/obj/item/clothing/head/hardhat/orange{
	name = "protective hat";
	pixel_y = 9
	},
/obj/item/clothing/head/hardhat/orange{
	name = "protective hat";
	pixel_y = 9
	},
/obj/item/clothing/head/hardhat/orange{
	name = "protective hat";
	pixel_y = 9
	},
/obj/structure/closet/crate/internals,
/obj/effect/turf_decal/bot,
/obj/structure/railing{
	dir = 1;
	layer = 3.1;
	pixel_y = 5
	},
/obj/machinery/light/red/directional/east,
/turf/open/floor/pod/dark,
/area/space)
"Kk" = (
/obj/machinery/light/small/directional/north,
/obj/effect/turf_decal/tile/blue,
/obj/effect/turf_decal/tile/blue{
	dir = 4
	},
/obj/structure/railing{
	dir = 1;
	layer = 3.1;
	pixel_y = 5
	},
/turf/open/floor/pod/light,
/area/space)
"Kv" = (
/obj/effect/turf_decal/trimline/red/arrow_ccw{
	dir = 4
	},
/obj/effect/turf_decal/trimline/red/arrow_cw{
	dir = 8
	},
/obj/machinery/status_display/ai{
	pixel_x = 32
	},
/obj/structure/railing{
	dir = 4;
	layer = 3.1;
	pixel_x = 5
	},
/obj/machinery/light/red/directional/east,
/turf/open/floor/pod/dark,
/area/space)
"KJ" = (
/obj/structure/chair/comfy/shuttle{
	dir = 4
	},
/obj/effect/turf_decal/trimline/blue,
/obj/structure/railing{
	dir = 1;
	layer = 3.1;
	pixel_y = 5
	},
/turf/open/floor/pod/dark,
/area/space)
"Lg" = (
/obj/machinery/status_display/ai,
/turf/closed/wall/mineral/plastitanium,
/area/space)
"Mb" = (
/obj/effect/turf_decal/bot,
/obj/effect/turf_decal/trimline/red/arrow_cw{
	dir = 5
	},
/obj/effect/turf_decal/trimline/red/arrow_ccw{
	dir = 9
	},
/obj/machinery/light/floor,
/turf/open/floor/pod/dark,
/area/space)
"MY" = (
/obj/machinery/computer{
	dir = 1;
	name = "Shuttle computer"
	},
/obj/effect/turf_decal/tile/blue,
/obj/effect/turf_decal/tile/blue{
	dir = 8
	},
/turf/open/floor/pod/light,
/area/space)
"Oc" = (
/obj/structure/window/reinforced,
/obj/structure/shuttle/engine/heater{
	dir = 1
	},
/obj/effect/turf_decal/stripes/line{
	dir = 1
	},
/turf/open/floor/plating/airless,
/area/space)
"PA" = (
/obj/effect/turf_decal/stripes/red/line{
	dir = 1
	},
/turf/open/floor/pod/light,
/area/space)
"QG" = (
/obj/structure/shuttle/engine/propulsion{
	dir = 1
	},
/obj/effect/turf_decal/stripes/line{
	dir = 1
	},
/turf/open/floor/plating/airless,
/area/space)
"Rw" = (
/obj/effect/spawner/structure/window/reinforced/shuttle,
/obj/effect/spawner/structure/window/reinforced/plasma/plastitanium,
/turf/open/floor/plating,
/area/space)
"RQ" = (
/obj/machinery/door/airlock/shuttle{
	name = "Arrival Shuttle Airlock"
	},
/obj/effect/turf_decal/stripes/line{
	dir = 8
	},
/obj/effect/turf_decal/stripes/line{
	dir = 4
	},
/turf/open/floor/pod/dark,
/area/space)
"RY" = (
/obj/effect/turf_decal/trimline/red/arrow_ccw{
	dir = 8
	},
/obj/effect/turf_decal/trimline/red/arrow_cw{
	dir = 4
	},
/obj/structure/railing{
	dir = 8;
	pixel_x = -3
	},
/turf/open/floor/pod/dark,
/area/space)
"Sw" = (
/obj/effect/turf_decal/trimline/red/arrow_ccw{
	dir = 4
	},
/obj/effect/turf_decal/trimline/red/arrow_cw{
	dir = 8
	},
/obj/structure/railing{
	dir = 8;
	pixel_x = -3
	},
/turf/open/floor/pod/dark,
/area/space)
"Tt" = (
/obj/effect/turf_decal/tile/neutral{
	dir = 1
	},
/obj/effect/turf_decal/tile/neutral{
	dir = 8
	},
/obj/effect/turf_decal/stripes/red/line{
	dir = 1
	},
/obj/effect/turf_decal/loading_area/red{
	dir = 8
	},
/turf/open/floor/pod/light,
/area/space)
"Uz" = (
/obj/effect/turf_decal/stripes/red/line,
/turf/open/floor/pod/light,
/area/space)
"UF" = (
/obj/effect/turf_decal/trimline/red/arrow_ccw{
	dir = 4
	},
/obj/effect/turf_decal/trimline/red/arrow_cw{
	dir = 8
	},
/obj/machinery/status_display/evac{
	pixel_x = -32
	},
/obj/structure/railing{
	dir = 8;
	pixel_x = -3
	},
/obj/machinery/light/red/directional/west,
/turf/open/floor/pod/dark,
/area/space)
"Vm" = (
/obj/effect/turf_decal/trimline/red/arrow_ccw{
	dir = 9
	},
/obj/structure/railing{
	dir = 8;
	pixel_x = -3
	},
/obj/effect/turf_decal/trimline/red/corner,
/turf/open/floor/pod/dark,
/area/space)
"VQ" = (
/obj/effect/turf_decal/stripes/line,
/obj/machinery/door/airlock/shuttle{
	name = "Arrival Shuttle Airlock"
	},
/obj/effect/turf_decal/stripes/line{
	dir = 1
	},
/turf/open/floor/pod/light,
/area/space)
"VT" = (
/obj/structure/extinguisher_cabinet{
	pixel_y = 32
	},
/obj/item/storage/firstaid/regular{
	pixel_x = 3;
	pixel_y = 3
	},
/obj/item/storage/firstaid/regular,
/obj/effect/turf_decal/bot,
/obj/structure/table/reinforced/plastitaniumglass,
/obj/structure/railing{
	dir = 1;
	layer = 3.1;
	pixel_y = 5
	},
/turf/open/floor/pod/dark,
/area/space)
"Yi" = (
/obj/effect/turf_decal/trimline/red/arrow_ccw{
	dir = 8
	},
/obj/effect/turf_decal/trimline/red/arrow_cw{
	dir = 4
	},
/obj/structure/railing{
	dir = 4;
	layer = 3.1;
	pixel_x = 5
	},
/turf/open/floor/pod/dark,
/area/space)
"ZL" = (
/obj/effect/turf_decal/trimline/red/arrow_ccw{
	dir = 4
	},
/obj/effect/turf_decal/trimline/red/arrow_cw{
	dir = 8
	},
/turf/open/floor/pod/dark,
/area/space)
"ZT" = (
/obj/effect/turf_decal/tile/blue,
/turf/open/floor/pod/dark,
/area/space)

(1,1,1) = {"
DS
Cf
Cf
cd
RQ
cd
jF
jF
jF
jF
Dl
RQ
cd
cd
DS
DS
DS
"}
(2,1,1) = {"
QG
Cf
cd
nw
rg
UF
Sw
tn
Vm
RY
wy
Tt
Ir
cd
DS
DS
DS
"}
(3,1,1) = {"
QG
Oc
jF
np
Uz
eU
kV
kV
kV
kV
oL
PA
KJ
cd
cd
Rw
cd
"}
(4,1,1) = {"
QG
Oc
jF
Hm
Uz
jy
kV
kV
kV
kV
GN
PA
ZT
iP
AY
Ca
Rw
"}
(5,1,1) = {"
ic
cd
Cf
VT
cX
ZL
ZL
pp
Mb
py
py
BU
hN
VQ
DL
MY
Rw
"}
(6,1,1) = {"
QG
Oc
jF
Br
Uz
fD
kV
kV
kV
kV
Cf
Dk
xR
Lg
Kk
Ca
Rw
"}
(7,1,1) = {"
QG
Oc
jF
np
Uz
jy
kV
kV
kV
kV
oL
PA
qh
cd
cd
Rw
cd
"}
(8,1,1) = {"
QG
Cf
cd
Ka
pT
Kv
xa
en
cw
Yi
Cj
kl
oi
cd
DS
DS
DS
"}
(9,1,1) = {"
DS
Cf
Cf
cd
RQ
cd
jF
jF
jF
jF
Dl
RQ
cd
cd
DS
DS
DS
"}
