//MAP CONVERTED BY dmm2tgm.py THIS HEADER COMMENT PREVENTS RECONVERSION, DO NOT REMOVE
"a" = (
/turf/template_noop,
/area/template_noop)
"e" = (
/obj/structure/shuttle/engine/propulsion/burst/left,
/turf/open/floor/plating,
/area/shuttle/arrival)
"f" = (
/obj/structure/table,
/obj/machinery/cell_charger,
/turf/open/floor/mineral/titanium/blue,
/area/shuttle/arrival)
"g" = (
/obj/machinery/requests_console{
	department = "Arrival shuttle";
	name = "Arrivals Shuttle console";
	pixel_x = -32
	},
/turf/open/floor/mineral/titanium/blue,
/area/shuttle/arrival)
"h" = (
/obj/item/radio/intercom{
	pixel_x = -30
	},
/turf/open/floor/mineral/titanium/blue,
/area/shuttle/arrival)
"i" = (
/obj/structure/closet/wardrobe/grey,
/turf/open/floor/mineral/titanium/blue,
/area/shuttle/arrival)
"j" = (
/obj/machinery/computer{
	name = "Shuttle computer"
	},
/turf/open/floor/mineral/titanium/blue,
/area/shuttle/arrival)
"l" = (
/obj/structure/chair/comfy/shuttle{
	dir = 8
	},
/obj/structure/window/reinforced/tinted,
/turf/open/floor/mineral/titanium/blue,
/area/shuttle/arrival)
"o" = (
/obj/item/clothing/suit/hazardvest{
	desc = "A high-visibility lifejacket complete with whistle and slot for oxygen tanks.";
	name = "emergency lifejacket"
	},
/obj/item/clothing/suit/hazardvest{
	desc = "A high-visibility lifejacket complete with whistle and slot for oxygen tanks.";
	name = "emergency lifejacket"
	},
/obj/item/clothing/suit/hazardvest{
	desc = "A high-visibility lifejacket complete with whistle and slot for oxygen tanks.";
	name = "emergency lifejacket"
	},
/obj/item/clothing/suit/hazardvest{
	desc = "A high-visibility lifejacket complete with whistle and slot for oxygen tanks.";
	name = "emergency lifejacket"
	},
/obj/item/clothing/suit/hazardvest{
	desc = "A high-visibility lifejacket complete with whistle and slot for oxygen tanks.";
	name = "emergency lifejacket"
	},
/obj/item/tank/internals/emergency_oxygen{
	pixel_x = 3
	},
/obj/item/tank/internals/emergency_oxygen{
	pixel_x = 3
	},
/obj/item/tank/internals/emergency_oxygen{
	pixel_x = 3
	},
/obj/item/tank/internals/emergency_oxygen{
	pixel_x = 3
	},
/obj/item/tank/internals/emergency_oxygen{
	pixel_x = 3
	},
/obj/item/clothing/mask/breath{
	pixel_x = -3;
	pixel_y = -3
	},
/obj/item/clothing/mask/breath{
	pixel_x = -3;
	pixel_y = -3
	},
/obj/item/clothing/mask/breath{
	pixel_x = -3;
	pixel_y = -3
	},
/obj/item/clothing/mask/breath{
	pixel_x = -3;
	pixel_y = -3
	},
/obj/item/clothing/mask/breath{
	pixel_x = -3;
	pixel_y = -3
	},
/obj/item/clothing/head/hardhat/orange{
	name = "protective hat";
	pixel_y = 9
	},
/obj/item/clothing/head/hardhat/orange{
	name = "protective hat";
	pixel_y = 9
	},
/obj/item/clothing/head/hardhat/orange{
	name = "protective hat";
	pixel_y = 9
	},
/obj/item/clothing/head/hardhat/orange{
	name = "protective hat";
	pixel_y = 9
	},
/obj/item/clothing/head/hardhat/orange{
	name = "protective hat";
	pixel_y = 9
	},
/obj/structure/closet/crate/internals,
/turf/open/floor/mineral/titanium/blue,
/area/shuttle/arrival)
"p" = (
/obj/item/radio/intercom{
	pixel_x = 30
	},
/turf/open/floor/mineral/titanium/blue,
/area/shuttle/arrival)
"q" = (
/obj/structure/chair/comfy/shuttle{
	dir = 4
	},
/turf/open/floor/mineral/titanium/blue,
/area/shuttle/arrival)
"r" = (
/obj/structure/table,
/obj/item/storage/firstaid/regular,
/turf/open/floor/mineral/titanium/blue,
/area/shuttle/arrival)
"s" = (
/obj/structure/chair/comfy/shuttle{
	dir = 4
	},
/obj/structure/window/reinforced/tinted,
/turf/open/floor/mineral/titanium/blue,
/area/shuttle/arrival)
"t" = (
/obj/structure/extinguisher_cabinet{
	pixel_y = 32
	},
/turf/open/floor/mineral/titanium/blue,
/area/shuttle/arrival)
"u" = (
/obj/machinery/vending/wallmed{
	name = "Emergency NanoMed";
	pixel_y = 28;
	use_power = 0
	},
/turf/open/floor/mineral/titanium/blue,
/area/shuttle/arrival)
"v" = (
/obj/structure/shuttle/engine/propulsion/burst/right,
/turf/open/floor/plating,
/area/shuttle/arrival)
"w" = (
/obj/structure/shuttle/engine/heater,
/obj/structure/window/reinforced{
	dir = 1
	},
/turf/open/floor/plating,
/area/shuttle/arrival)
"x" = (
/turf/open/floor/mineral/titanium/blue,
/area/shuttle/arrival)
"y" = (
/obj/structure/closet/wardrobe/mixed,
/turf/open/floor/mineral/titanium/blue,
/area/shuttle/arrival)
"z" = (
/obj/structure/table,
/obj/item/paper_bin,
/obj/item/pen,
/turf/open/floor/mineral/titanium/blue,
/area/shuttle/arrival)
"A" = (
/obj/structure/shuttle/engine/propulsion,
/turf/open/floor/plating,
/area/shuttle/arrival)
"B" = (
/turf/closed/wall/mineral/titanium/nodiagonal,
/area/shuttle/arrival)
"C" = (
/obj/machinery/door/airlock/titanium{
	name = "Arrivals Shuttle Airlock"
	},
/turf/open/floor/mineral/titanium/blue,
/area/shuttle/arrival)
"E" = (
/turf/closed/wall/mineral/titanium,
/area/shuttle/arrival)
"G" = (
/obj/structure/chair/comfy/shuttle{
	dir = 8
	},
/turf/open/floor/mineral/titanium/blue,
/area/shuttle/arrival)
"H" = (
/obj/structure/closet/emcloset,
/obj/item/storage/toolbox/emergency,
/turf/open/floor/mineral/titanium/blue,
/area/shuttle/arrival)
"I" = (
/obj/effect/turf_decal/stripes/line{
	dir = 8
	},
/turf/open/floor/mineral/titanium/blue,
/area/shuttle/arrival)
"L" = (
/obj/effect/spawner/structure/window/shuttle,
/obj/docking_port/mobile/arrivals{
	dheight = 7;
	dwidth = 0;
	height = 17;
	width = 11
	},
/turf/open/floor/plating,
/area/shuttle/arrival)
"N" = (
/obj/structure/closet/wardrobe/green,
/turf/open/floor/mineral/titanium/blue,
/area/shuttle/arrival)
"P" = (
/obj/effect/spawner/structure/window/shuttle,
/turf/open/floor/plating,
/area/shuttle/arrival)
"T" = (
/obj/structure/chair/comfy/shuttle{
	dir = 1
	},
/turf/open/floor/mineral/titanium/blue,
/area/shuttle/arrival)
"U" = (
/obj/structure/closet/wardrobe/yellow,
/turf/open/floor/mineral/titanium/blue,
/area/shuttle/arrival)
"V" = (
/obj/structure/closet/wardrobe/black,
/turf/open/floor/mineral/titanium/blue,
/area/shuttle/arrival)
"W" = (
/obj/machinery/computer/arcade,
/turf/open/floor/mineral/titanium/blue,
/area/shuttle/arrival)
"Y" = (
/obj/structure/chair/comfy/shuttle,
/turf/open/floor/mineral/titanium/blue,
/area/shuttle/arrival)
"Z" = (
/obj/effect/turf_decal/stripes/full,
/obj/machinery/door/airlock/external,
/turf/open/floor/plating,
/area/shuttle/arrival)

(1,1,1) = {"
a
a
a
a
E
P
P
E
P
Z
P
E
P
P
E
a
a
"}
(2,1,1) = {"
a
a
a
E
E
f
z
x
x
I
x
g
H
H
E
E
E
"}
(3,1,1) = {"
a
a
a
P
W
x
x
x
x
x
x
p
x
x
V
w
e
"}
(4,1,1) = {"
a
E
E
B
u
x
T
E
Y
x
T
E
Y
x
U
w
e
"}
(5,1,1) = {"
P
P
q
s
x
x
T
P
Y
x
T
P
Y
x
y
w
A
"}
(6,1,1) = {"
P
j
x
x
x
x
T
P
Y
x
T
P
Y
x
o
w
A
"}
(7,1,1) = {"
P
P
G
l
x
x
T
P
Y
x
T
P
Y
x
y
w
A
"}
(8,1,1) = {"
a
E
E
B
t
x
T
E
Y
x
T
E
Y
x
N
w
v
"}
(9,1,1) = {"
a
a
a
P
W
x
x
h
x
x
x
x
x
x
i
w
v
"}
(10,1,1) = {"
a
a
a
E
E
x
x
x
x
r
x
x
x
x
E
E
E
"}
(11,1,1) = {"
a
a
a
a
E
E
C
E
P
L
P
E
C
E
E
a
a
"}
