//MAP CONVERTED BY dmm2tgm.py THIS HEADER COMMENT PREVENTS RECONVERSION, DO NOT REMOVE
"a" = (
/turf/closed/wall/mineral/titanium,
/area/space)
"e" = (
/obj/effect/spawner/structure/window/reinforced/shuttle,
/turf/open/floor/plating,
/area/space)
"g" = (
/turf/open/space/basic,
/turf/closed/wall/mineral/titanium,
/area/space)
"k" = (
/obj/structure/shuttle/engine/heater{
	dir = 4
	},
/obj/structure/window/reinforced{
	dir = 8
	},
/turf/open/floor/plating,
/area/space)
"l" = (
/obj/structure/table,
/obj/item/storage/medkit/regular{
	pixel_x = 2;
	pixel_y = 3
	},
/obj/item/crowbar,
/turf/open/floor/mineral/titanium/white,
/area/space)
"p" = (
/obj/structure/table,
/obj/item/storage/medkit/fire,
/turf/open/floor/mineral/titanium/white,
/area/space)
"q" = (
/obj/structure/closet/wardrobe/green,
/turf/open/floor/mineral/titanium/white,
/area/space)
"s" = (
/turf/open/floor/mineral/titanium/white,
/area/space)
"u" = (
/obj/structure/chair{
	dir = 4
	},
/obj/structure/window/reinforced{
	dir = 8
	},
/obj/effect/landmark/latejoin,
/turf/open/floor/mineral/titanium/white,
/area/space)
"y" = (
/obj/structure/shuttle/engine/propulsion{
	dir = 8
	},
/turf/open/floor/plating,
/area/space)
"F" = (
/obj/structure/chair{
	dir = 8
	},
/obj/structure/window/reinforced{
	dir = 4
	},
/obj/effect/landmark/latejoin,
/turf/open/floor/mineral/titanium/white,
/area/space)
"L" = (
/turf/open/space/basic,
/area/space)
"R" = (
/obj/effect/spawner/structure/window/reinforced/shuttle,
/turf/open/floor/mineral/titanium/white,
/area/space)
"W" = (
/obj/machinery/door/airlock/shuttle{
	name = "Emergency Shuttle Airlock"
	},
/turf/open/floor/mineral/titanium/white,
/area/space)
"Y" = (
/obj/structure/grille,
/obj/structure/window/reinforced/shuttle,
/turf/open/floor/mineral/titanium/white,
/area/space)

(1,1,1) = {"
a
R
W
Y
a
a
R
W
R
a
"}
(2,1,1) = {"
a
l
s
q
a
a
p
s
q
a
"}
(3,1,1) = {"
a
F
s
F
a
a
F
s
F
a
"}
(4,1,1) = {"
a
u
s
u
a
a
u
s
u
a
"}
(5,1,1) = {"
e
F
s
F
e
e
F
s
F
e
"}
(6,1,1) = {"
a
u
s
u
a
a
u
s
u
a
"}
(7,1,1) = {"
a
F
s
F
a
a
F
s
F
a
"}
(8,1,1) = {"
a
u
s
u
a
a
u
s
u
a
"}
(9,1,1) = {"
g
k
R
k
g
g
k
R
k
g
"}
(10,1,1) = {"
L
y
L
y
L
L
y
L
y
L
"}
