//MAP CONVERTED BY dmm2tgm.py THIS HEADER COMMENT PREVENTS RECONVERSION, DO NOT REMOVE
"e" = (
/obj/effect/spawner/structure/window/reinforced/shuttle,
/turf/open/floor/plating,
/area/shuttle/arrival)
"g" = (
/turf/closed/wall/mineral/titanium,
/area/shuttle/arrival)
"k" = (
/obj/structure/shuttle/engine/heater{
	dir = 4
	},
/obj/structure/window/reinforced{
	dir = 8
	},
/turf/open/floor/plating,
/area/shuttle/arrival)
"l" = (
/obj/structure/table,
/obj/item/storage/medkit/regular{
	pixel_x = 2;
	pixel_y = 3
	},
/obj/item/crowbar,
/turf/open/floor/mineral/titanium/white,
/area/shuttle/arrival)
"p" = (
/obj/structure/table,
/obj/item/storage/medkit/fire,
/turf/open/floor/mineral/titanium/white,
/area/shuttle/arrival)
"q" = (
/obj/structure/closet/wardrobe/green,
/turf/open/floor/mineral/titanium/white,
/area/shuttle/arrival)
"s" = (
/turf/open/floor/mineral/titanium/white,
/area/shuttle/arrival)
"u" = (
/obj/structure/chair{
	dir = 4
	},
/obj/structure/window/reinforced{
	dir = 8
	},
/obj/effect/landmark/latejoin,
/turf/open/floor/mineral/titanium/white,
/area/shuttle/arrival)
"y" = (
/obj/structure/shuttle/engine/propulsion{
	dir = 8
	},
/turf/open/floor/plating,
/area/shuttle/arrival)
"F" = (
/obj/structure/chair{
	dir = 8
	},
/obj/structure/window/reinforced{
	dir = 4
	},
/obj/effect/landmark/latejoin,
/turf/open/floor/mineral/titanium/white,
/area/shuttle/arrival)
"L" = (
/turf/open/space/basic,
/area/template_noop)
"R" = (
/obj/effect/spawner/structure/window/reinforced/shuttle,
/turf/open/floor/mineral/titanium/white,
/area/shuttle/arrival)
"W" = (
/obj/machinery/door/airlock/shuttle{
	name = "Emergency Shuttle Airlock"
	},
/turf/open/floor/mineral/titanium/white,
/area/shuttle/arrival)
"Y" = (
/obj/structure/grille,
/obj/structure/window/reinforced/shuttle,
/turf/open/floor/mineral/titanium/white,
/area/shuttle/arrival)

(1,1,1) = {"
g
R
W
Y
g
g
R
W
R
g
"}
(2,1,1) = {"
g
l
s
q
g
g
p
s
q
g
"}
(3,1,1) = {"
g
F
s
F
g
g
F
s
F
g
"}
(4,1,1) = {"
g
u
s
u
g
g
u
s
u
g
"}
(5,1,1) = {"
e
F
s
F
e
e
F
s
F
e
"}
(6,1,1) = {"
g
u
s
u
g
g
u
s
u
g
"}
(7,1,1) = {"
g
F
s
F
g
g
F
s
F
g
"}
(8,1,1) = {"
g
u
s
u
g
g
u
s
u
g
"}
(9,1,1) = {"
g
k
R
k
g
g
k
R
k
g
"}
(10,1,1) = {"
L
y
L
y
L
L
y
L
y
L
"}
