//MAP CONVERTED BY dmm2tgm.py THIS HEADER COMMENT PREVENTS RECONVERSION, DO NOT REMOVE
"a" = (
/turf/template_noop,
/area/template_noop)
"b" = (
/obj/machinery/light/floor,
/turf/open/floor/mineral/titanium/white,
/area/shuttle/arrival)
"c" = (
/turf/open/floor/mineral/titanium/white,
/area/shuttle/arrival)
"e" = (
/obj/structure/sign/nanotrasen,
/turf/closed/wall/mineral/titanium,
/area/shuttle/arrival)
"f" = (
/obj/effect/turf_decal/siding/white{
	dir = 4
	},
/turf/open/floor/mineral/titanium/white,
/area/shuttle/arrival)
"j" = (
/obj/effect/turf_decal/tile/neutral/tram,
/obj/effect/turf_decal/caution{
	dir = 1
	},
/obj/structure/fans/tiny,
/turf/open/floor/mineral/titanium/blue,
/area/shuttle/arrival)
"l" = (
/obj/structure/chair/sofa/bench/tram/right{
	dir = 8
	},
/obj/effect/turf_decal/box/white/corners{
	color = "#52B4E9";
	dir = 1
	},
/obj/effect/turf_decal/box/white/corners{
	color = "#52B4E9";
	dir = 4
	},
/turf/open/floor/mineral/titanium/white,
/area/shuttle/arrival)
"m" = (
/obj/effect/turf_decal/tile/neutral/tram,
/obj/effect/turf_decal/caution,
/obj/structure/fans/tiny,
/turf/open/floor/mineral/titanium/blue,
/area/shuttle/arrival)
"o" = (
/obj/structure/chair/sofa/bench/tram/left{
	dir = 8
	},
/obj/effect/turf_decal/box/white/corners{
	color = "#52B4E9"
	},
/obj/effect/turf_decal/box/white/corners{
	color = "#52B4E9";
	dir = 8
	},
/obj/effect/turf_decal/siding/white{
	dir = 8
	},
/obj/item/radio/intercom/directional/south,
/turf/open/floor/mineral/titanium/white,
/area/shuttle/arrival)
"p" = (
/obj/effect/turf_decal/siding/white{
	dir = 8
	},
/turf/open/floor/mineral/titanium/white,
/area/shuttle/arrival)
"q" = (
/obj/machinery/power/shuttle_engine/propulsion{
	dir = 4
	},
/obj/docking_port/mobile/arrivals{
	name = "heliostation arrivals shuttle"
	},
/turf/open/floor/plating/airless,
/area/shuttle/arrival)
"r" = (
/obj/effect/turf_decal/tile/neutral/tram,
/obj/effect/turf_decal/caution{
	dir = 1
	},
/obj/machinery/door/airlock/multi_tile{
	name = "Arrivals Shuttle Airlock"
	},
/obj/structure/fans/tiny,
/turf/open/floor/mineral/titanium/blue,
/area/shuttle/arrival)
"s" = (
/obj/structure/chair/sofa/bench/tram{
	dir = 8
	},
/turf/open/floor/mineral/titanium/white,
/area/shuttle/arrival)
"t" = (
/obj/effect/turf_decal/trimline/white/warning,
/turf/open/floor/mineral/titanium/blue,
/area/shuttle/arrival)
"v" = (
/turf/closed/wall/mineral/titanium,
/area/shuttle/arrival)
"x" = (
/obj/structure/chair/comfy/shuttle{
	dir = 8
	},
/turf/open/floor/mineral/titanium/white,
/area/shuttle/arrival)
"y" = (
/obj/structure/chair/sofa/bench/tram/right{
	dir = 8
	},
/obj/effect/turf_decal/box/white/corners{
	color = "#52B4E9";
	dir = 1
	},
/obj/effect/turf_decal/box/white/corners{
	color = "#52B4E9";
	dir = 4
	},
/obj/effect/turf_decal/siding/white{
	dir = 8
	},
/turf/open/floor/mineral/titanium/white,
/area/shuttle/arrival)
"z" = (
/obj/structure/closet/wardrobe/mixed,
/obj/structure/extinguisher_cabinet/directional/south,
/turf/open/floor/mineral/titanium/white,
/area/shuttle/arrival)
"B" = (
/obj/machinery/computer{
	dir = 4;
	name = "Shuttle computer"
	},
/obj/effect/turf_decal/delivery,
/obj/effect/turf_decal/tile/blue/full,
/turf/open/floor/mineral/titanium/white,
/area/shuttle/arrival)
"D" = (
/obj/structure/chair/sofa/bench/tram/left{
	dir = 8
	},
/obj/effect/turf_decal/box/white/corners{
	color = "#52B4E9"
	},
/obj/effect/turf_decal/box/white/corners{
	color = "#52B4E9";
	dir = 8
	},
/obj/effect/turf_decal/siding/white{
	dir = 4
	},
/turf/open/floor/mineral/titanium/white,
/area/shuttle/arrival)
"E" = (
/obj/machinery/power/shuttle_engine/heater{
	dir = 4
	},
/obj/structure/window/reinforced/survival_pod/spawner/directional/west,
/turf/open/floor/plating/airless,
/area/shuttle/arrival)
"G" = (
/turf/open/floor/mineral/titanium/blue,
/area/shuttle/arrival)
"I" = (
/obj/effect/turf_decal/trimline/white/warning{
	dir = 1
	},
/turf/open/floor/mineral/titanium/blue,
/area/shuttle/arrival)
"K" = (
/obj/structure/table/reinforced,
/obj/item/storage/medkit/o2,
/obj/item/clothing/mask/breath,
/obj/item/clothing/mask/breath,
/obj/item/tank/internals/emergency_oxygen,
/obj/item/tank/internals/emergency_oxygen,
/obj/effect/turf_decal/tile/blue/full,
/turf/open/floor/mineral/titanium/white,
/area/shuttle/arrival)
"L" = (
/obj/structure/chair/sofa/bench/tram/right{
	dir = 8
	},
/obj/effect/turf_decal/box/white/corners{
	color = "#52B4E9";
	dir = 1
	},
/obj/effect/turf_decal/box/white/corners{
	color = "#52B4E9";
	dir = 4
	},
/obj/effect/turf_decal/siding/white{
	dir = 8
	},
/obj/item/radio/intercom/directional/north,
/turf/open/floor/mineral/titanium/white,
/area/shuttle/arrival)
"O" = (
/obj/structure/chair/sofa/bench/tram/right{
	dir = 8
	},
/obj/effect/turf_decal/box/white/corners{
	color = "#52B4E9";
	dir = 1
	},
/obj/effect/turf_decal/box/white/corners{
	color = "#52B4E9";
	dir = 4
	},
/obj/effect/turf_decal/siding/white{
	dir = 4
	},
/turf/open/floor/mineral/titanium/white,
/area/shuttle/arrival)
"P" = (
/obj/effect/spawner/structure/window/reinforced/shuttle,
/turf/open/floor/plating,
/area/shuttle/arrival)
"R" = (
/obj/machinery/power/shuttle_engine/propulsion{
	dir = 4
	},
/turf/open/floor/plating/airless,
/area/shuttle/arrival)
"S" = (
/obj/structure/chair/sofa/bench/tram/left{
	dir = 8
	},
/obj/effect/turf_decal/box/white/corners{
	color = "#52B4E9"
	},
/obj/effect/turf_decal/box/white/corners{
	color = "#52B4E9";
	dir = 8
	},
/obj/effect/turf_decal/siding/white{
	dir = 8
	},
/turf/open/floor/mineral/titanium/white,
/area/shuttle/arrival)
"W" = (
/obj/structure/chair/sofa/bench/tram/left{
	dir = 8
	},
/obj/effect/turf_decal/box/white/corners{
	color = "#52B4E9"
	},
/obj/effect/turf_decal/box/white/corners{
	color = "#52B4E9";
	dir = 8
	},
/turf/open/floor/mineral/titanium/white,
/area/shuttle/arrival)
"X" = (
/obj/structure/table/reinforced,
/obj/item/storage/medkit/regular{
	pixel_y = 4
	},
/obj/item/storage/toolbox/emergency,
/obj/effect/turf_decal/tile/blue/full,
/turf/open/floor/mineral/titanium/white,
/area/shuttle/arrival)
"Y" = (
/obj/effect/turf_decal/tile/neutral/tram,
/obj/effect/turf_decal/caution,
/obj/machinery/door/airlock/multi_tile{
	name = "Arrivals Shuttle Airlock"
	},
/obj/structure/fans/tiny,
/turf/open/floor/mineral/titanium/blue,
/area/shuttle/arrival)
"Z" = (
/obj/structure/closet/wardrobe/grey,
/obj/machinery/requests_console/directional/north{
	department = "Arrivals shuttle";
	name = "Arrival Shuttle Requests Console"
	},
/turf/open/floor/mineral/titanium/white,
/area/shuttle/arrival)

(1,1,1) = {"
a
v
P
P
P
v
a
"}
(2,1,1) = {"
v
v
X
B
K
v
v
"}
(3,1,1) = {"
v
Z
c
x
c
z
v
"}
(4,1,1) = {"
P
c
c
b
c
c
P
"}
(5,1,1) = {"
e
O
D
f
O
D
e
"}
(6,1,1) = {"
Y
I
G
G
G
t
r
"}
(7,1,1) = {"
m
I
G
G
G
t
j
"}
(8,1,1) = {"
v
L
S
p
y
o
v
"}
(9,1,1) = {"
P
c
c
b
c
c
P
"}
(10,1,1) = {"
v
l
s
s
s
W
v
"}
(11,1,1) = {"
v
v
E
E
E
v
v
"}
(12,1,1) = {"
a
v
R
q
R
v
a
"}
