//MAP CONVERTED BY dmm2tgm.py THIS HEADER COMMENT PREVENTS RECONVERSION, DO NOT REMOVE
"cd" = (
/turf/closed/wall/mineral/titanium,
/area/shuttle/arrival)
"cw" = (
/obj/structure/railing{
	dir = 4;
	layer = 3.1;
	pixel_x = 5
	},
/obj/effect/turf_decal/trimline/blue/arrow_cw{
	dir = 5
	},
/obj/effect/turf_decal/trimline/blue/corner{
	dir = 8
	},
/turf/open/floor/iron,
/area/shuttle/arrival)
"cX" = (
/obj/effect/turf_decal/trimline/blue/warning,
/obj/effect/turf_decal/trimline/blue/end{
	dir = 1
	},
/obj/effect/turf_decal/bot,
/obj/machinery/light/floor,
/obj/effect/turf_decal/trimline/blue/arrow_ccw{
	dir = 1
	},
/turf/open/floor/iron,
/area/shuttle/arrival)
"en" = (
/obj/structure/railing{
	dir = 4;
	layer = 3.1;
	pixel_x = 5
	},
/obj/effect/turf_decal/trimline/blue/arrow_ccw{
	dir = 6
	},
/obj/effect/turf_decal/trimline/blue/corner{
	dir = 1
	},
/turf/open/floor/iron,
/area/shuttle/arrival)
"eU" = (
/obj/machinery/door/airlock/shuttle{
	name = "Arrival Shuttle Airlock"
	},
/obj/effect/turf_decal/stripes/line{
	dir = 8
	},
/obj/effect/turf_decal/stripes/line{
	dir = 4
	},
/turf/open/floor/iron,
/area/shuttle/arrival)
"fD" = (
/obj/structure/closet/firecloset,
/turf/open/floor/iron,
/area/shuttle/arrival)
"hN" = (
/obj/effect/turf_decal/tile/blue,
/obj/effect/turf_decal/tile/blue{
	dir = 8
	},
/obj/machinery/light/floor,
/turf/open/floor/iron,
/area/shuttle/arrival)
"ic" = (
/turf/closed/wall/mineral/plastitanium,
/area/shuttle/arrival)
"iP" = (
/obj/machinery/status_display/evac,
/turf/closed/wall/mineral/titanium,
/area/shuttle/arrival)
"jy" = (
/obj/structure/closet/wardrobe/grey,
/turf/open/floor/iron,
/area/shuttle/arrival)
"kl" = (
/obj/effect/turf_decal/tile/neutral,
/obj/effect/turf_decal/tile/neutral{
	dir = 4
	},
/obj/effect/turf_decal/trimline/blue/warning{
	dir = 1
	},
/obj/effect/turf_decal/trimline/blue/arrow_cw{
	dir = 6
	},
/obj/effect/turf_decal/trimline/blue/corner{
	dir = 1
	},
/turf/open/floor/iron,
/area/shuttle/arrival)
"kV" = (
/obj/structure/railing{
	dir = 1;
	layer = 3.1;
	pixel_y = 5
	},
/obj/structure/chair/comfy/shuttle,
/obj/effect/turf_decal/trimline/blue,
/obj/effect/turf_decal/bot,
/turf/open/floor/iron,
/area/shuttle/arrival)
"np" = (
/obj/effect/turf_decal/delivery,
/obj/structure/closet/wardrobe/mixed,
/obj/structure/railing{
	dir = 1;
	layer = 3.1;
	pixel_y = 5
	},
/turf/open/floor/iron,
/area/shuttle/arrival)
"nw" = (
/obj/item/clothing/suit/hazardvest{
	desc = "A high-visibility lifejacket complete with whistle and slot for oxygen tanks.";
	name = "emergency lifejacket"
	},
/obj/item/clothing/suit/hazardvest{
	desc = "A high-visibility lifejacket complete with whistle and slot for oxygen tanks.";
	name = "emergency lifejacket"
	},
/obj/item/clothing/suit/hazardvest{
	desc = "A high-visibility lifejacket complete with whistle and slot for oxygen tanks.";
	name = "emergency lifejacket"
	},
/obj/item/clothing/suit/hazardvest{
	desc = "A high-visibility lifejacket complete with whistle and slot for oxygen tanks.";
	name = "emergency lifejacket"
	},
/obj/item/clothing/suit/hazardvest{
	desc = "A high-visibility lifejacket complete with whistle and slot for oxygen tanks.";
	name = "emergency lifejacket"
	},
/obj/item/tank/internals/emergency_oxygen{
	pixel_x = 3
	},
/obj/item/tank/internals/emergency_oxygen{
	pixel_x = 3
	},
/obj/item/tank/internals/emergency_oxygen{
	pixel_x = 3
	},
/obj/item/tank/internals/emergency_oxygen{
	pixel_x = 3
	},
/obj/item/tank/internals/emergency_oxygen{
	pixel_x = 3
	},
/obj/item/clothing/mask/breath{
	pixel_x = -3;
	pixel_y = -3
	},
/obj/item/clothing/mask/breath{
	pixel_x = -3;
	pixel_y = -3
	},
/obj/item/clothing/mask/breath{
	pixel_x = -3;
	pixel_y = -3
	},
/obj/item/clothing/mask/breath{
	pixel_x = -3;
	pixel_y = -3
	},
/obj/item/clothing/mask/breath{
	pixel_x = -3;
	pixel_y = -3
	},
/obj/item/clothing/head/hardhat/orange{
	name = "protective hat";
	pixel_y = 9
	},
/obj/item/clothing/head/hardhat/orange{
	name = "protective hat";
	pixel_y = 9
	},
/obj/item/clothing/head/hardhat/orange{
	name = "protective hat";
	pixel_y = 9
	},
/obj/item/clothing/head/hardhat/orange{
	name = "protective hat";
	pixel_y = 9
	},
/obj/item/clothing/head/hardhat/orange{
	name = "protective hat";
	pixel_y = 9
	},
/obj/structure/closet/crate/internals,
/obj/effect/turf_decal/bot,
/obj/structure/railing{
	dir = 1;
	layer = 3.1;
	pixel_y = 5
	},
/obj/machinery/light/directional/west,
/turf/open/floor/iron,
/area/shuttle/arrival)
"oi" = (
/obj/item/storage/briefcase{
	pixel_x = 3;
	pixel_y = 3
	},
/obj/item/storage/secure/briefcase,
/obj/effect/turf_decal/bot,
/obj/structure/table/reinforced/plastitaniumglass,
/obj/machinery/light/directional/east,
/turf/open/floor/iron,
/area/shuttle/arrival)
"oL" = (
/obj/structure/railing{
	dir = 1;
	layer = 3.1;
	pixel_y = 5
	},
/turf/open/floor/iron,
/area/shuttle/arrival)
"pp" = (
/obj/effect/turf_decal/trimline/blue/arrow_cw{
	dir = 10
	},
/obj/effect/turf_decal/trimline/blue/arrow_ccw{
	dir = 6
	},
/turf/open/floor/iron,
/area/shuttle/arrival)
"py" = (
/obj/effect/turf_decal/trimline/blue/arrow_ccw{
	dir = 8
	},
/obj/effect/turf_decal/trimline/blue/arrow_cw{
	dir = 4
	},
/turf/open/floor/iron,
/area/shuttle/arrival)
"pT" = (
/obj/effect/turf_decal/tile/neutral,
/obj/effect/turf_decal/tile/neutral{
	dir = 4
	},
/obj/effect/turf_decal/trimline/blue/warning,
/obj/effect/turf_decal/trimline/blue/corner{
	dir = 8
	},
/obj/effect/turf_decal/trimline/blue/arrow_ccw{
	dir = 5
	},
/turf/open/floor/iron,
/area/shuttle/arrival)
"qh" = (
/obj/structure/chair/comfy/shuttle{
	dir = 8
	},
/obj/effect/turf_decal/trimline/blue,
/obj/structure/railing{
	dir = 1;
	layer = 3.1;
	pixel_y = 5
	},
/obj/effect/turf_decal/bot,
/turf/open/floor/iron,
/area/shuttle/arrival)
"rg" = (
/obj/effect/turf_decal/tile/neutral{
	dir = 1
	},
/obj/effect/turf_decal/tile/neutral{
	dir = 8
	},
/obj/effect/turf_decal/trimline/blue/warning,
/obj/effect/turf_decal/trimline/blue/arrow_ccw{
	dir = 1
	},
/obj/effect/turf_decal/trimline/blue/corner{
	dir = 8
	},
/obj/effect/turf_decal/trimline/blue/arrow_ccw{
	dir = 5
	},
/obj/effect/turf_decal/arrows{
	dir = 8
	},
/turf/open/floor/iron,
/area/shuttle/arrival)
"tn" = (
/obj/structure/railing{
	dir = 8;
	pixel_x = -3
	},
/obj/effect/turf_decal/trimline/blue/arrow_cw{
	dir = 10
	},
/obj/effect/turf_decal/trimline/blue/corner{
	dir = 4
	},
/turf/open/floor/iron,
/area/shuttle/arrival)
"wy" = (
/obj/structure/railing{
	dir = 8;
	pixel_x = -3
	},
/obj/effect/turf_decal/trimline/blue/arrow_ccw{
	dir = 8
	},
/obj/effect/turf_decal/trimline/blue/arrow_cw{
	dir = 4
	},
/obj/machinery/light/directional/west,
/turf/open/floor/iron,
/area/shuttle/arrival)
"xa" = (
/obj/structure/railing{
	dir = 4;
	layer = 3.1;
	pixel_x = 5
	},
/obj/effect/turf_decal/trimline/blue/arrow_ccw{
	dir = 4
	},
/obj/effect/turf_decal/trimline/blue/arrow_cw{
	dir = 8
	},
/turf/open/floor/iron,
/area/shuttle/arrival)
"xR" = (
/obj/effect/turf_decal/tile/blue{
	dir = 8
	},
/turf/open/floor/iron,
/area/shuttle/arrival)
"AY" = (
/obj/machinery/light/small/directional/north,
/obj/effect/turf_decal/tile/blue{
	dir = 1
	},
/obj/effect/turf_decal/tile/blue{
	dir = 8
	},
/obj/structure/railing{
	dir = 1;
	layer = 3.1;
	pixel_y = 5
	},
/turf/open/floor/iron,
/area/shuttle/arrival)
"Br" = (
/obj/machinery/cell_charger,
/obj/effect/turf_decal/bot,
/obj/structure/table/reinforced/plastitaniumglass,
/obj/structure/railing{
	dir = 1;
	layer = 3.1;
	pixel_y = 5
	},
/turf/open/floor/iron,
/area/shuttle/arrival)
"BU" = (
/obj/machinery/holopad,
/obj/effect/turf_decal/trimline/blue/warning{
	dir = 1
	},
/obj/effect/turf_decal/trimline/blue/end,
/obj/effect/turf_decal/trimline/blue/arrow_cw,
/turf/open/floor/iron,
/area/shuttle/arrival)
"Ca" = (
/obj/machinery/computer{
	dir = 1;
	name = "Shuttle computer"
	},
/obj/effect/turf_decal/tile/blue{
	dir = 1
	},
/obj/effect/turf_decal/tile/blue,
/obj/effect/turf_decal/tile/blue{
	dir = 4
	},
/obj/effect/turf_decal/tile/blue{
	dir = 8
	},
/turf/open/floor/iron,
/area/shuttle/arrival)
"Cf" = (
/turf/closed/wall/mineral/titanium/nodiagonal,
/area/shuttle/arrival)
"Cj" = (
/obj/structure/railing{
	dir = 4;
	layer = 3.1;
	pixel_x = 5
	},
/obj/effect/turf_decal/trimline/blue/arrow_ccw{
	dir = 8
	},
/obj/effect/turf_decal/trimline/blue/arrow_cw{
	dir = 4
	},
/obj/machinery/light/directional/east,
/turf/open/floor/iron,
/area/shuttle/arrival)
"Dk" = (
/obj/machinery/vending/wallmed/directional/north{
	use_power = 0
	},
/obj/effect/turf_decal/trimline/blue/warning{
	dir = 1
	},
/obj/effect/turf_decal/trimline/blue/arrow_cw,
/turf/open/floor/iron,
/area/shuttle/arrival)
"Dl" = (
/obj/structure/sign/nanotrasen,
/turf/closed/wall/mineral/titanium,
/area/shuttle/arrival)
"DL" = (
/obj/effect/turf_decal/tile/blue{
	dir = 1
	},
/obj/effect/turf_decal/tile/blue{
	dir = 4
	},
/obj/structure/chair/comfy/shuttle,
/obj/effect/turf_decal/trimline/blue,
/obj/effect/turf_decal/trimline/blue,
/obj/effect/turf_decal/trimline/blue/end,
/obj/effect/turf_decal/bot_red,
/turf/open/floor/iron,
/area/shuttle/arrival)
"DS" = (
/turf/template_noop,
/area/template_noop)
"GN" = (
/obj/machinery/requests_console{
	department = "Arrival shuttle";
	name = "Arrivals Shuttle console"
	},
/turf/closed/wall/mineral/titanium/nodiagonal,
/area/shuttle/arrival)
"Hm" = (
/obj/item/storage/toolbox/emergency,
/obj/effect/turf_decal/bot,
/obj/structure/table/reinforced/plastitaniumglass,
/obj/structure/railing{
	dir = 1;
	layer = 3.1;
	pixel_y = 5
	},
/turf/open/floor/iron,
/area/shuttle/arrival)
"Ir" = (
/obj/item/paper_bin,
/obj/item/pen,
/obj/effect/turf_decal/bot,
/obj/item/radio/intercom/directional/west,
/obj/structure/table/reinforced/plastitaniumglass,
/obj/machinery/light/directional/west,
/turf/open/floor/iron,
/area/shuttle/arrival)
"Ka" = (
/obj/item/clothing/suit/hazardvest{
	desc = "A high-visibility lifejacket complete with whistle and slot for oxygen tanks.";
	name = "emergency lifejacket"
	},
/obj/item/clothing/suit/hazardvest{
	desc = "A high-visibility lifejacket complete with whistle and slot for oxygen tanks.";
	name = "emergency lifejacket"
	},
/obj/item/clothing/suit/hazardvest{
	desc = "A high-visibility lifejacket complete with whistle and slot for oxygen tanks.";
	name = "emergency lifejacket"
	},
/obj/item/clothing/suit/hazardvest{
	desc = "A high-visibility lifejacket complete with whistle and slot for oxygen tanks.";
	name = "emergency lifejacket"
	},
/obj/item/clothing/suit/hazardvest{
	desc = "A high-visibility lifejacket complete with whistle and slot for oxygen tanks.";
	name = "emergency lifejacket"
	},
/obj/item/tank/internals/emergency_oxygen{
	pixel_x = 3
	},
/obj/item/tank/internals/emergency_oxygen{
	pixel_x = 3
	},
/obj/item/tank/internals/emergency_oxygen{
	pixel_x = 3
	},
/obj/item/tank/internals/emergency_oxygen{
	pixel_x = 3
	},
/obj/item/tank/internals/emergency_oxygen{
	pixel_x = 3
	},
/obj/item/clothing/mask/breath{
	pixel_x = -3;
	pixel_y = -3
	},
/obj/item/clothing/mask/breath{
	pixel_x = -3;
	pixel_y = -3
	},
/obj/item/clothing/mask/breath{
	pixel_x = -3;
	pixel_y = -3
	},
/obj/item/clothing/mask/breath{
	pixel_x = -3;
	pixel_y = -3
	},
/obj/item/clothing/mask/breath{
	pixel_x = -3;
	pixel_y = -3
	},
/obj/item/clothing/head/hardhat/orange{
	name = "protective hat";
	pixel_y = 9
	},
/obj/item/clothing/head/hardhat/orange{
	name = "protective hat";
	pixel_y = 9
	},
/obj/item/clothing/head/hardhat/orange{
	name = "protective hat";
	pixel_y = 9
	},
/obj/item/clothing/head/hardhat/orange{
	name = "protective hat";
	pixel_y = 9
	},
/obj/item/clothing/head/hardhat/orange{
	name = "protective hat";
	pixel_y = 9
	},
/obj/structure/closet/crate/internals,
/obj/effect/turf_decal/bot,
/obj/structure/railing{
	dir = 1;
	layer = 3.1;
	pixel_y = 5
	},
/obj/machinery/light/directional/east,
/turf/open/floor/iron,
/area/shuttle/arrival)
"Kk" = (
/obj/machinery/light/small/directional/north,
/obj/effect/turf_decal/tile/blue,
/obj/effect/turf_decal/tile/blue{
	dir = 4
	},
/obj/structure/railing{
	dir = 1;
	layer = 3.1;
	pixel_y = 5
	},
/turf/open/floor/iron,
/area/shuttle/arrival)
"Kv" = (
/obj/machinery/status_display/ai{
	pixel_x = 32
	},
/obj/structure/railing{
	dir = 4;
	layer = 3.1;
	pixel_x = 5
	},
/obj/effect/turf_decal/trimline/blue/arrow_ccw{
	dir = 4
	},
/obj/effect/turf_decal/trimline/blue/arrow_cw{
	dir = 8
	},
/obj/machinery/light/directional/east,
/turf/open/floor/iron,
/area/shuttle/arrival)
"KJ" = (
/obj/structure/chair/comfy/shuttle{
	dir = 4
	},
/obj/effect/turf_decal/trimline/blue,
/obj/structure/railing{
	dir = 1;
	layer = 3.1;
	pixel_y = 5
	},
/obj/effect/turf_decal/bot,
/turf/open/floor/iron,
/area/shuttle/arrival)
"Lg" = (
/obj/machinery/status_display/ai,
/turf/closed/wall/mineral/titanium,
/area/shuttle/arrival)
"Mb" = (
/obj/machinery/light/floor,
/obj/effect/turf_decal/trimline/blue/arrow_cw{
	dir = 5
	},
/obj/effect/turf_decal/trimline/blue/arrow_ccw{
	dir = 9
	},
/turf/open/floor/iron,
/area/shuttle/arrival)
"MY" = (
/obj/machinery/computer{
	dir = 1;
	name = "Shuttle computer"
	},
/obj/effect/turf_decal/tile/blue,
/obj/effect/turf_decal/tile/blue{
	dir = 8
	},
/turf/open/floor/iron,
/area/shuttle/arrival)
"Oc" = (
/obj/structure/window/reinforced,
/obj/structure/shuttle/engine/heater{
	dir = 1
	},
/obj/effect/turf_decal/stripes/line{
	dir = 1
	},
/turf/open/floor/plating/airless,
/area/shuttle/arrival)
"OV" = (
/obj/effect/spawner/structure/window/reinforced/shuttle,
/obj/docking_port/mobile/arrivals{
	dir = 1;
	dwidth = 4
	},
/turf/open/floor/plating,
/area/shuttle/arrival)
"PA" = (
/obj/effect/turf_decal/trimline/blue/warning{
	dir = 1
	},
/obj/effect/turf_decal/trimline/blue/arrow_cw,
/turf/open/floor/iron,
/area/shuttle/arrival)
"QG" = (
/obj/structure/shuttle/engine/propulsion{
	dir = 1
	},
/obj/effect/turf_decal/stripes/line{
	dir = 1
	},
/turf/open/floor/plating/airless,
/area/shuttle/arrival)
"Rw" = (
/obj/effect/spawner/structure/window/reinforced/shuttle,
/turf/open/floor/plating,
/area/shuttle/arrival)
"RY" = (
/obj/structure/railing{
	dir = 8;
	pixel_x = -3
	},
/obj/effect/turf_decal/trimline/blue/arrow_ccw{
	dir = 8
	},
/obj/effect/turf_decal/trimline/blue/arrow_cw{
	dir = 4
	},
/turf/open/floor/iron,
/area/shuttle/arrival)
"Sw" = (
/obj/structure/railing{
	dir = 8;
	pixel_x = -3
	},
/obj/effect/turf_decal/trimline/blue/arrow_ccw{
	dir = 4
	},
/obj/effect/turf_decal/trimline/blue/arrow_cw{
	dir = 8
	},
/turf/open/floor/iron,
/area/shuttle/arrival)
"Tt" = (
/obj/effect/turf_decal/tile/neutral{
	dir = 1
	},
/obj/effect/turf_decal/tile/neutral{
	dir = 8
	},
/obj/effect/turf_decal/trimline/blue/warning{
	dir = 1
	},
/obj/effect/turf_decal/trimline/blue/corner{
	dir = 1
	},
/obj/effect/turf_decal/trimline/blue/arrow_cw,
/obj/effect/turf_decal/trimline/blue/arrow_cw{
	dir = 6
	},
/obj/effect/turf_decal/arrows{
	dir = 8
	},
/turf/open/floor/iron,
/area/shuttle/arrival)
"Uz" = (
/obj/effect/turf_decal/trimline/blue/warning,
/obj/effect/turf_decal/trimline/blue/arrow_ccw{
	dir = 1
	},
/turf/open/floor/iron,
/area/shuttle/arrival)
"UF" = (
/obj/machinery/status_display/evac{
	pixel_x = -32
	},
/obj/structure/railing{
	dir = 8;
	pixel_x = -3
	},
/obj/effect/turf_decal/trimline/blue/arrow_ccw{
	dir = 4
	},
/obj/effect/turf_decal/trimline/blue/arrow_cw{
	dir = 8
	},
/obj/machinery/light/directional/west,
/turf/open/floor/iron,
/area/shuttle/arrival)
"Vm" = (
/obj/structure/railing{
	dir = 8;
	pixel_x = -3
	},
/obj/effect/turf_decal/trimline/blue/arrow_ccw{
	dir = 9
	},
/obj/effect/turf_decal/trimline/blue/corner,
/turf/open/floor/iron,
/area/shuttle/arrival)
"VQ" = (
/obj/effect/turf_decal/stripes/line,
/obj/machinery/door/airlock/shuttle{
	name = "Arrival Shuttle Airlock"
	},
/obj/effect/turf_decal/stripes/line{
	dir = 1
	},
/turf/open/floor/iron,
/area/shuttle/arrival)
"VT" = (
/obj/structure/extinguisher_cabinet{
	pixel_y = 32
	},
/obj/item/storage/medkit/regular{
	pixel_x = 3;
	pixel_y = 3
	},
/obj/item/storage/medkit/regular,
/obj/effect/turf_decal/bot,
/obj/structure/table/reinforced/plastitaniumglass,
/obj/structure/railing{
	dir = 1;
	layer = 3.1;
	pixel_y = 5
	},
/turf/open/floor/iron,
/area/shuttle/arrival)
"Yi" = (
/obj/structure/railing{
	dir = 4;
	layer = 3.1;
	pixel_x = 5
	},
/obj/effect/turf_decal/trimline/blue/arrow_ccw{
	dir = 8
	},
/obj/effect/turf_decal/trimline/blue/arrow_cw{
	dir = 4
	},
/turf/open/floor/iron,
/area/shuttle/arrival)
"ZL" = (
/obj/effect/turf_decal/trimline/blue/arrow_ccw{
	dir = 4
	},
/obj/effect/turf_decal/trimline/blue/arrow_cw{
	dir = 8
	},
/turf/open/floor/iron,
/area/shuttle/arrival)
"ZT" = (
/obj/effect/turf_decal/tile/blue,
/turf/open/floor/iron,
/area/shuttle/arrival)

(1,1,1) = {"
DS
Cf
Cf
cd
eU
cd
Rw
Rw
Rw
Rw
Dl
eU
cd
cd
DS
DS
DS
"}
(2,1,1) = {"
QG
Cf
cd
nw
rg
UF
Sw
tn
Vm
RY
wy
Tt
Ir
cd
DS
DS
DS
"}
(3,1,1) = {"
QG
Oc
Rw
np
Uz
jy
kV
kV
kV
kV
oL
PA
KJ
cd
cd
Rw
cd
"}
(4,1,1) = {"
QG
Oc
Rw
Hm
Uz
fD
kV
kV
kV
kV
GN
PA
ZT
iP
AY
Ca
Rw
"}
(5,1,1) = {"
ic
cd
Cf
VT
cX
ZL
ZL
pp
Mb
py
py
BU
hN
VQ
DL
MY
OV
"}
(6,1,1) = {"
QG
Oc
Rw
Br
Uz
fD
kV
kV
kV
kV
Cf
Dk
xR
Lg
Kk
Ca
Rw
"}
(7,1,1) = {"
QG
Oc
Rw
np
Uz
jy
kV
kV
kV
kV
oL
PA
qh
cd
cd
Rw
cd
"}
(8,1,1) = {"
QG
Cf
cd
Ka
pT
Kv
xa
en
cw
Yi
Cj
kl
oi
cd
DS
DS
DS
"}
(9,1,1) = {"
DS
Cf
Cf
cd
cd
cd
Rw
Rw
Rw
Rw
Dl
cd
cd
cd
DS
DS
DS
"}
