//MAP CONVERTED BY dmm2tgm.py THIS HEADER COMMENT PREVENTS RECONVERSION, DO NOT REMOVE
"b" = (
/obj/machinery/vending/wallmed/directional/north,
/turf/open/floor/mineral/titanium/tiled/white,
/area/shuttle/arrival)
"e" = (
/turf/open/floor/mineral/titanium/tiled/white,
/area/shuttle/arrival)
"g" = (
/obj/machinery/power/shuttle_engine/propulsion/burst/left{
	dir = 4
	},
/obj/docking_port/mobile/arrivals,
/turf/open/floor/plating/airless,
/area/shuttle/arrival)
"l" = (
/obj/structure/extinguisher_cabinet/directional/north,
/turf/open/floor/mineral/titanium/tiled/purple,
/area/shuttle/arrival)
"p" = (
/obj/item/radio/intercom/directional/south,
/turf/open/floor/mineral/titanium/tiled/purple,
/area/shuttle/arrival)
"s" = (
/obj/machinery/power/shuttle_engine/propulsion/burst/left{
	dir = 4
	},
/turf/open/floor/plating/airless,
/area/shuttle/arrival)
"v" = (
/obj/machinery/light/small/directional/south,
/turf/open/floor/mineral/titanium/tiled/white,
/area/shuttle/arrival)
"w" = (
/obj/effect/spawner/structure/window/reinforced/shuttle,
/turf/open/floor/plating,
/area/shuttle/arrival)
"x" = (
/obj/structure/chair/comfy/shuttle{
	dir = 8
	},
/turf/open/floor/mineral/titanium/tiled/purple,
/area/shuttle/arrival)
"B" = (
/obj/structure/chair/comfy/shuttle{
	dir = 4
	},
/turf/open/floor/mineral/titanium/tiled/purple,
/area/shuttle/arrival)
"E" = (
/obj/machinery/power/shuttle_engine/heater{
	dir = 4
	},
/obj/structure/window/reinforced/spawner/directional/west,
/turf/open/floor/plating/airless,
/area/shuttle/arrival)
"F" = (
/obj/item/radio/intercom/directional/north,
/turf/open/floor/mineral/titanium/tiled/purple,
/area/shuttle/arrival)
"G" = (
/obj/machinery/door/airlock/titanium{
	name = "Arrivals Shuttle Airlock"
	},
/obj/structure/fans/tiny,
/turf/open/floor/mineral/titanium/tiled/white,
/area/shuttle/arrival)
"H" = (
/turf/closed/wall/mineral/titanium/overspace,
/area/shuttle/arrival)
"L" = (
/obj/structure/chair/comfy/shuttle{
	dir = 8
	},
/obj/machinery/light/small/directional/north,
/turf/open/floor/mineral/titanium/tiled/purple,
/area/shuttle/arrival)
"M" = (
/obj/structure/chair/comfy/shuttle{
	dir = 8
	},
/obj/machinery/light/directional/south,
/turf/open/floor/mineral/titanium/tiled/purple,
/area/shuttle/arrival)
"N" = (
/obj/structure/extinguisher_cabinet/directional/south,
/turf/open/floor/mineral/titanium/tiled/purple,
/area/shuttle/arrival)
"P" = (
/turf/open/floor/mineral/titanium/tiled/purple,
/area/shuttle/arrival)
"R" = (
/obj/structure/chair/comfy/shuttle{
	dir = 4
	},
/obj/machinery/light/directional/west,
/turf/open/floor/mineral/titanium/tiled/purple,
/area/shuttle/arrival)
"W" = (
/obj/structure/chair/comfy/shuttle{
	dir = 8
	},
/obj/machinery/light/small/directional/south,
/turf/open/floor/mineral/titanium/tiled/purple,
/area/shuttle/arrival)
"X" = (
/obj/structure/closet/emcloset,
/obj/item/clothing/mask/breath,
/obj/item/clothing/mask/breath,
/obj/item/tank/internals/emergency_oxygen,
/obj/item/tank/internals/emergency_oxygen,
/obj/item/storage/medkit/o2,
/obj/structure/window/reinforced/spawner/directional/west,
/obj/item/crowbar,
/turf/open/floor/mineral/titanium/tiled/white,
/area/shuttle/arrival)
"Z" = (
/turf/closed/wall/mineral/titanium,
/area/shuttle/arrival)

(1,1,1) = {"
Z
w
w
w
Z
"}
(2,1,1) = {"
Z
B
R
B
Z
"}
(3,1,1) = {"
G
e
e
e
G
"}
(4,1,1) = {"
Z
F
e
N
Z
"}
(5,1,1) = {"
w
x
e
x
w
"}
(6,1,1) = {"
w
x
e
M
w
"}
(7,1,1) = {"
w
x
e
x
w
"}
(8,1,1) = {"
Z
P
e
P
Z
"}
(9,1,1) = {"
G
e
e
e
G
"}
(10,1,1) = {"
Z
l
e
p
Z
"}
(11,1,1) = {"
w
L
e
W
w
"}
(12,1,1) = {"
w
X
e
X
w
"}
(13,1,1) = {"
Z
b
e
v
Z
"}
(14,1,1) = {"
Z
E
E
E
Z
"}
(15,1,1) = {"
H
s
g
s
H
"}
