//MAP CONVERTED BY dmm2tgm.py THIS HEADER COMMENT PREVENTS RECONVERSION, DO NOT REMOVE
"a" = (
/obj/structure/shuttle/engine/propulsion/burst/left,
/obj/effect/turf_decal/stripes/line,
/turf/open/floor/plating/airless,
/area/space)
"b" = (
/obj/effect/decal/cleanable/dirt,
/obj/machinery/light/directional/west,
/turf/open/floor/mineral/titanium,
/area/space)
"c" = (
/obj/machinery/conveyor{
	dir = 8;
	id = "cargoshuttle";
	name = "cargo shuttle conveyor belt"
	},
/obj/effect/decal/cleanable/dirt,
/turf/open/floor/mineral/titanium,
/area/space)
"g" = (
/obj/machinery/conveyor{
	id = "cargoshuttle";
	name = "cargo shuttle conveyor belt"
	},
/obj/effect/decal/cleanable/dirt,
/turf/open/floor/mineral/titanium,
/area/space)
"h" = (
/obj/effect/decal/cleanable/dirt,
/obj/effect/decal/cleanable/dirt,
/obj/effect/decal/cleanable/dirt,
/obj/effect/decal/cleanable/dirt,
/obj/machinery/light/directional/east,
/turf/open/floor/mineral/titanium,
/area/space)
"l" = (
/turf/open/floor/mineral/titanium,
/area/space)
"m" = (
/obj/effect/decal/cleanable/dirt,
/obj/effect/decal/cleanable/dirt,
/obj/machinery/light/directional/east,
/turf/open/floor/mineral/titanium,
/area/space)
"p" = (
/obj/machinery/door/airlock/titanium{
	name = "Supply Shuttle Airlock";
	req_access_txt = "31"
	},
/turf/closed/wall/mineral/titanium,
/area/space)
"r" = (
/obj/machinery/conveyor{
	dir = 4;
	id = "cargoshuttle";
	name = "cargo shuttle conveyor belt"
	},
/turf/open/floor/mineral/titanium,
/area/space)
"u" = (
/obj/machinery/conveyor{
	dir = 8;
	id = "cargoshuttle";
	name = "cargo shuttle conveyor belt"
	},
/turf/open/floor/mineral/titanium,
/area/space)
"w" = (
/obj/machinery/conveyor{
	id = "cargoshuttle";
	name = "cargo shuttle conveyor belt"
	},
/turf/open/floor/mineral/titanium,
/area/space)
"y" = (
/obj/machinery/conveyor{
	dir = 4;
	id = "cargoshuttle";
	name = "cargo shuttle conveyor belt"
	},
/obj/effect/decal/cleanable/dirt,
/turf/open/floor/mineral/titanium,
/area/space)
"A" = (
/obj/machinery/light/directional/west,
/turf/open/floor/mineral/titanium,
/area/space)
"B" = (
/obj/effect/decal/cleanable/dirt,
/turf/open/floor/mineral/titanium,
/area/space)
"C" = (
/obj/structure/window/reinforced{
	dir = 1
	},
/obj/structure/shuttle/engine/heater,
/obj/effect/decal/cleanable/dirt,
/obj/effect/turf_decal/stripes/line,
/turf/open/floor/plating/airless,
/area/space)
"D" = (
/obj/structure/shuttle/engine/propulsion/burst/right,
/obj/effect/turf_decal/stripes/line,
/turf/open/floor/plating/airless,
/area/space)
"G" = (
/obj/machinery/door/airlock/titanium{
	name = "Supply Shuttle Airlock";
	req_access_txt = "31"
	},
/obj/docking_port/mobile/supply,
/turf/closed/wall/mineral/titanium,
/area/space)
"J" = (
/obj/machinery/conveyor{
	dir = 4;
	id = "cargoshuttle";
	name = "cargo shuttle conveyor belt"
	},
/turf/closed/wall/mineral/titanium,
/area/space)
"L" = (
/obj/machinery/conveyor_switch/oneway{
	id = "cargoshuttle"
	},
/obj/effect/decal/cleanable/dirt,
/turf/open/floor/mineral/titanium,
/area/space)
"O" = (
/obj/machinery/conveyor{
	dir = 8;
	id = "cargoshuttle";
	name = "cargo shuttle conveyor belt"
	},
/obj/effect/decal/cleanable/dirt,
/turf/closed/wall/mineral/titanium,
/area/space)
"Q" = (
/turf/closed/wall/mineral/titanium,
/area/space)
"R" = (
/obj/structure/window/reinforced{
	dir = 1
	},
/obj/structure/shuttle/engine/heater,
/obj/effect/turf_decal/stripes/line,
/turf/open/floor/plating/airless,
/area/space)
"T" = (
/obj/structure/shuttle/engine/propulsion,
/obj/effect/turf_decal/stripes/line,
/turf/open/floor/plating/airless,
/area/space)
"V" = (
/obj/effect/decal/cleanable/dirt,
/obj/effect/decal/cleanable/dirt,
/turf/open/floor/mineral/titanium,
/area/space)

(1,1,1) = {"
Q
Q
Q
Q
Q
Q
Q
Q
Q
Q
Q
a
"}
(2,1,1) = {"
Q
y
b
l
l
b
B
l
A
c
R
T
"}
(3,1,1) = {"
Q
r
l
B
B
l
B
V
l
c
R
T
"}
(4,1,1) = {"
Q
y
B
B
B
l
B
B
B
u
C
T
"}
(5,1,1) = {"
Q
w
w
y
h
L
m
g
w
c
C
T
"}
(6,1,1) = {"
Q
Q
Q
J
p
Q
G
O
Q
Q
Q
D
"}
