//MAP CONVERTED BY dmm2tgm.py THIS HEADER COMMENT PREVENTS RECONVERSION, DO NOT REMOVE
"a" = (
/obj/structure/shuttle/engine/propulsion/burst/left,
/obj/effect/turf_decal/stripes/line,
/turf/open/floor/plating/airless,
/area/space)
"b" = (
/obj/effect/decal/cleanable/dirt,
/obj/machinery/light/directional/west,
/obj/structure/railing{
	dir = 8;
	pixel_x = -3
	},
/obj/effect/decal/cleanable/generic,
/obj/effect/turf_decal/stripes/white/line{
	dir = 1
	},
/turf/open/floor/mineral/titanium,
/area/space)
"c" = (
/obj/machinery/conveyor{
	dir = 8;
	id = "cargoshuttle";
	name = "cargo shuttle conveyor belt"
	},
/obj/effect/decal/cleanable/dirt,
/obj/structure/railing{
	layer = 3.1;
	pixel_y = -5
	},
/turf/open/floor/mineral/titanium,
/area/space)
"d" = (
/obj/effect/decal/cleanable/dirt,
/obj/structure/railing{
	dir = 8;
	pixel_x = -3
	},
/obj/effect/decal/cleanable/dirt/dust,
/obj/effect/turf_decal/trimline/blue/arrow_cw{
	dir = 10
	},
/turf/open/floor/mineral/titanium,
/area/space)
"g" = (
/obj/machinery/conveyor{
	id = "cargoshuttle";
	name = "cargo shuttle conveyor belt"
	},
/obj/effect/decal/cleanable/dirt,
/turf/open/floor/mineral/titanium,
/area/space)
"h" = (
/obj/effect/decal/cleanable/dirt,
/obj/effect/decal/cleanable/dirt,
/obj/effect/decal/cleanable/dirt,
/obj/effect/decal/cleanable/dirt,
/obj/machinery/light/directional/east,
/obj/effect/turf_decal/stripes/white/line{
	dir = 1
	},
/obj/effect/turf_decal/trimline/blue/arrow_cw{
	dir = 1
	},
/turf/open/floor/mineral/titanium,
/area/space)
"i" = (
/obj/structure/railing{
	dir = 8;
	pixel_x = -3
	},
/turf/open/floor/mineral/titanium,
/area/space)
"k" = (
/obj/machinery/conveyor{
	id = "cargoshuttle";
	name = "cargo shuttle conveyor belt"
	},
/obj/effect/decal/cleanable/dirt/dust,
/obj/effect/decal/cleanable/dirt/dust,
/turf/open/floor/mineral/titanium,
/area/space)
"l" = (
/obj/effect/decal/cleanable/dirt/dust,
/obj/effect/decal/cleanable/dirt/dust,
/obj/effect/turf_decal/stripes/white/line{
	dir = 1
	},
/turf/open/floor/mineral/titanium,
/area/space)
"m" = (
/obj/effect/decal/cleanable/dirt,
/obj/effect/decal/cleanable/dirt,
/obj/machinery/light/directional/east,
/obj/effect/decal/cleanable/generic,
/obj/effect/turf_decal/stripes/white/line,
/obj/effect/turf_decal/trimline/blue/arrow_cw,
/turf/open/floor/mineral/titanium,
/area/space)
"n" = (
/obj/machinery/conveyor{
	dir = 4;
	id = "cargoshuttle";
	name = "cargo shuttle conveyor belt"
	},
/obj/effect/decal/cleanable/dirt,
/obj/effect/decal/cleanable/dirt/dust,
/turf/open/floor/mineral/titanium,
/area/space)
"p" = (
/obj/machinery/door/airlock/titanium{
	name = "Supply Shuttle Airlock";
	req_access_txt = "31"
	},
/obj/effect/decal/cleanable/dirt/dust,
/turf/open/floor/mineral/titanium,
/area/space)
"q" = (
/obj/effect/decal/cleanable/dirt,
/obj/effect/decal/cleanable/dirt/dust,
/obj/effect/turf_decal/trimline/blue/arrow_cw,
/turf/open/floor/mineral/titanium,
/area/space)
"r" = (
/obj/machinery/conveyor{
	dir = 4;
	id = "cargoshuttle";
	name = "cargo shuttle conveyor belt"
	},
/obj/structure/railing{
	dir = 1;
	layer = 3.1;
	pixel_y = 5
	},
/obj/effect/decal/cleanable/dirt/dust,
/turf/open/floor/mineral/titanium,
/area/space)
"s" = (
/obj/structure/railing{
	dir = 8;
	pixel_x = -3
	},
/obj/effect/decal/cleanable/dirt/dust,
/turf/open/floor/mineral/titanium,
/area/space)
"u" = (
/obj/machinery/conveyor{
	dir = 8;
	id = "cargoshuttle";
	name = "cargo shuttle conveyor belt"
	},
/obj/structure/railing{
	layer = 3.1;
	pixel_y = -5
	},
/turf/open/floor/mineral/titanium,
/area/space)
"v" = (
/obj/effect/decal/cleanable/dirt,
/obj/effect/decal/cleanable/dirt/dust,
/turf/open/floor/mineral/titanium,
/area/space)
"w" = (
/obj/machinery/conveyor{
	id = "cargoshuttle";
	name = "cargo shuttle conveyor belt"
	},
/obj/structure/railing{
	dir = 1;
	layer = 3.1;
	pixel_y = 5
	},
/obj/effect/decal/cleanable/dirt/dust,
/obj/effect/decal/cleanable/dirt/dust,
/turf/open/floor/mineral/titanium,
/area/space)
"y" = (
/obj/machinery/conveyor{
	dir = 4;
	id = "cargoshuttle";
	name = "cargo shuttle conveyor belt"
	},
/obj/effect/decal/cleanable/dirt,
/obj/structure/railing{
	dir = 1;
	layer = 3.1;
	pixel_y = 5
	},
/turf/open/floor/mineral/titanium,
/area/space)
"A" = (
/obj/machinery/light/directional/west,
/obj/structure/railing{
	dir = 8;
	pixel_x = -3
	},
/obj/effect/decal/cleanable/dirt/dust,
/obj/effect/turf_decal/stripes/white/line,
/turf/open/floor/mineral/titanium,
/area/space)
"B" = (
/obj/effect/decal/cleanable/dirt,
/obj/effect/decal/cleanable/dirt/dust,
/obj/effect/decal/cleanable/dirt/dust,
/obj/effect/decal/cleanable/glass,
/obj/effect/turf_decal/stripes/white/line{
	dir = 4
	},
/obj/effect/turf_decal/stripes/white/line{
	dir = 1
	},
/turf/open/floor/mineral/titanium,
/area/space)
"C" = (
/obj/structure/window/reinforced{
	dir = 1
	},
/obj/structure/shuttle/engine/heater,
/obj/effect/decal/cleanable/dirt,
/obj/effect/turf_decal/stripes/line,
/turf/open/floor/plating/airless,
/area/space)
"D" = (
/obj/structure/shuttle/engine/propulsion/burst/right,
/obj/effect/turf_decal/stripes/line,
/turf/open/floor/plating/airless,
/area/space)
"G" = (
/obj/machinery/door/airlock/titanium{
	name = "Supply Shuttle Airlock";
	req_access_txt = "31"
	},
/obj/effect/decal/cleanable/dirt/dust,
/obj/docking_port/mobile/supply{
	dwidth = 4;
	height = 6
	},
/turf/open/floor/mineral/titanium,
/area/space)
"H" = (
/obj/effect/decal/cleanable/dirt,
/obj/effect/turf_decal/trimline/blue/arrow_cw{
	dir = 1
	},
/turf/open/floor/mineral/titanium,
/area/space)
"I" = (
/obj/machinery/conveyor{
	id = "cargoshuttle";
	name = "cargo shuttle conveyor belt"
	},
/turf/open/floor/mineral/titanium,
/area/space)
"J" = (
/obj/machinery/conveyor{
	dir = 4;
	id = "cargoshuttle";
	name = "cargo shuttle conveyor belt"
	},
/obj/structure/plasticflaps/opaque,
/turf/open/floor/mineral/titanium,
/area/space)
"K" = (
/obj/machinery/conveyor{
	dir = 4;
	id = "cargoshuttle";
	name = "cargo shuttle conveyor belt"
	},
/obj/effect/decal/cleanable/dirt,
/obj/structure/railing{
	dir = 1;
	layer = 3.1;
	pixel_y = 5
	},
/obj/effect/decal/cleanable/dirt/dust,
/obj/effect/decal/cleanable/dirt/dust,
/turf/open/floor/mineral/titanium,
/area/space)
"L" = (
/obj/machinery/conveyor_switch/oneway{
	id = "cargoshuttle"
	},
/obj/effect/decal/cleanable/dirt,
/obj/effect/turf_decal/trimline/blue,
/turf/open/floor/mineral/titanium,
/area/space)
"M" = (
/obj/effect/decal/cleanable/dirt/dust,
/obj/effect/decal/cleanable/generic,
/obj/effect/turf_decal/stripes/white/line,
/turf/open/floor/mineral/titanium,
/area/space)
"O" = (
/obj/machinery/conveyor{
	dir = 8;
	id = "cargoshuttle";
	name = "cargo shuttle conveyor belt"
	},
/obj/effect/decal/cleanable/dirt,
/obj/structure/plasticflaps/opaque,
/turf/open/floor/mineral/titanium,
/area/space)
"P" = (
/obj/effect/decal/cleanable/dirt/dust,
/turf/open/floor/mineral/titanium,
/area/space)
"Q" = (
/turf/closed/wall/mineral/titanium,
/area/space)
"R" = (
/obj/structure/window/reinforced{
	dir = 1
	},
/obj/structure/shuttle/engine/heater,
/obj/effect/turf_decal/stripes/line,
/turf/open/floor/plating/airless,
/area/space)
"S" = (
/obj/structure/railing{
	dir = 8;
	pixel_x = -3
	},
/obj/effect/turf_decal/trimline/blue/arrow_cw{
	dir = 9
	},
/turf/open/floor/mineral/titanium,
/area/space)
"T" = (
/obj/structure/shuttle/engine/propulsion,
/obj/effect/turf_decal/stripes/line,
/turf/open/floor/plating/airless,
/area/space)
"U" = (
/obj/effect/decal/cleanable/dirt,
/obj/effect/decal/cleanable/dirt/dust,
/obj/effect/turf_decal/stripes/white/line,
/obj/effect/turf_decal/stripes/white/line{
	dir = 4
	},
/turf/open/floor/mineral/titanium,
/area/space)
"V" = (
/obj/effect/decal/cleanable/dirt,
/obj/effect/decal/cleanable/dirt,
/obj/effect/decal/cleanable/dirt/dust,
/turf/open/floor/mineral/titanium,
/area/space)
"Y" = (
/obj/effect/decal/cleanable/dirt,
/obj/effect/decal/cleanable/dirt/dust,
/obj/effect/turf_decal/stripes/white/line{
	dir = 4
	},
/turf/open/floor/mineral/titanium,
/area/space)
"Z" = (
/obj/effect/decal/cleanable/dirt,
/obj/machinery/light/directional/west,
/obj/structure/railing{
	dir = 8;
	pixel_x = -3
	},
/obj/effect/decal/cleanable/dirt/dust,
/obj/effect/turf_decal/trimline/blue/arrow_cw{
	dir = 8
	},
/turf/open/floor/mineral/titanium,
/area/space)

(1,1,1) = {"
Q
Q
Q
Q
Q
Q
Q
Q
Q
Q
Q
a
"}
(2,1,1) = {"
Q
y
b
i
S
Z
d
s
A
c
R
T
"}
(3,1,1) = {"
Q
r
l
v
H
P
q
V
M
c
R
T
"}
(4,1,1) = {"
Q
K
B
Y
H
P
q
Y
U
u
C
T
"}
(5,1,1) = {"
Q
w
k
n
h
L
m
g
I
c
C
T
"}
(6,1,1) = {"
Q
Q
Q
J
p
Q
G
O
Q
Q
Q
D
"}
