//MAP CONVERTED BY dmm2tgm.py THIS HEADER COMMENT PREVENTS RECONVERSION, DO NOT REMOVE
"b" = (
/obj/effect/turf_decal/siding/thinplating_new/light/corner{
	dir = 8
	},
/obj/machinery/light/directional/east,
/turf/open/floor/mineral/titanium/white,
/area/shuttle/supply)
"c" = (
/obj/machinery/conveyor{
	dir = 9;
	id = "QMLoad2"
	},
/turf/open/floor/mineral/titanium/white,
/area/shuttle/supply)
"d" = (
/obj/machinery/conveyor{
	dir = 5;
	id = "QMLoad"
	},
/turf/open/floor/mineral/titanium/white,
/area/shuttle/supply)
"e" = (
/obj/effect/turf_decal/siding/thinplating_new/light/corner{
	dir = 4
	},
/obj/machinery/conveyor_switch/oneway{
	id = "QMLoad2"
	},
/turf/open/floor/mineral/titanium/white,
/area/shuttle/supply)
"f" = (
/obj/machinery/power/shuttle_engine/heater{
	dir = 1
	},
/obj/structure/window/reinforced/plasma/spawner/directional/west,
/obj/structure/window/reinforced/plasma/spawner/directional/east,
/obj/structure/window/reinforced/plasma/spawner/directional/south,
/turf/open/floor/plating/airless,
/area/shuttle/supply)
"i" = (
/obj/machinery/conveyor{
	dir = 1;
	id = "QMLoad2"
	},
/turf/open/floor/mineral/titanium/white,
/area/shuttle/supply)
"k" = (
/obj/machinery/conveyor{
	dir = 4;
	id = "QMLoad"
	},
/turf/open/floor/mineral/titanium/white,
/area/shuttle/supply)
"l" = (
/obj/machinery/conveyor{
	dir = 1;
	id = "QMLoad2"
	},
/obj/machinery/light/directional/west,
/turf/open/floor/mineral/titanium/white,
/area/shuttle/supply)
"m" = (
/obj/effect/turf_decal/siding/thinplating_new/light/corner,
/obj/machinery/conveyor_switch/oneway{
	dir = 1;
	id = "QMLoad"
	},
/turf/open/floor/mineral/titanium/white,
/area/shuttle/supply)
"n" = (
/obj/machinery/conveyor{
	dir = 8;
	id = "QMLoad2"
	},
/turf/open/floor/mineral/titanium/white,
/area/shuttle/supply)
"o" = (
/turf/closed/wall/mineral/titanium,
/area/shuttle/supply)
"p" = (
/obj/effect/spawner/structure/window/reinforced/shuttle,
/turf/open/floor/plating,
/area/shuttle/supply)
"q" = (
/obj/effect/turf_decal/siding/thinplating_new/light{
	dir = 8
	},
/turf/open/floor/mineral/titanium/white,
/area/shuttle/supply)
"s" = (
/obj/machinery/power/shuttle_engine/propulsion/burst/left,
/obj/structure/window/reinforced/plasma/spawner/directional/west,
/obj/structure/window/reinforced/plasma/spawner/directional/east,
/turf/open/floor/plating/airless,
/area/shuttle/supply)
"t" = (
/obj/machinery/conveyor{
	dir = 8;
	id = "QMLoad2"
	},
/obj/structure/plasticflaps/opaque,
/turf/open/floor/mineral/titanium/blue,
/area/shuttle/supply)
"u" = (
/obj/machinery/power/shuttle_engine/heater,
/obj/structure/window/reinforced/plasma/spawner/directional/west,
/obj/structure/window/reinforced/plasma/spawner/directional/east,
/obj/structure/window/reinforced/plasma/spawner/directional/north,
/turf/open/floor/plating/airless,
/area/shuttle/supply)
"z" = (
/obj/machinery/conveyor/inverted{
	dir = 6;
	id = "QMLoad2"
	},
/turf/open/floor/mineral/titanium/white,
/area/shuttle/supply)
"C" = (
/obj/machinery/conveyor/inverted{
	dir = 10;
	id = "QMLoad"
	},
/turf/open/floor/mineral/titanium/white,
/area/shuttle/supply)
"E" = (
/turf/open/floor/mineral/titanium/white,
/area/shuttle/supply)
"H" = (
/obj/effect/turf_decal/siding/thinplating_new/light{
	dir = 4
	},
/turf/open/floor/mineral/titanium/white,
/area/shuttle/supply)
"L" = (
/obj/effect/turf_decal/siding/thinplating_new/light,
/turf/open/floor/mineral/titanium/white,
/area/shuttle/supply)
"N" = (
/obj/effect/turf_decal/siding/thinplating_new/light{
	dir = 1
	},
/turf/open/floor/mineral/titanium/white,
/area/shuttle/supply)
"P" = (
/obj/machinery/conveyor{
	dir = 4;
	id = "QMLoad"
	},
/obj/structure/plasticflaps/opaque,
/turf/open/floor/mineral/titanium/purple,
/area/shuttle/supply)
"R" = (
/obj/machinery/light/floor,
/obj/effect/spawner/structure/window/reinforced/shuttle,
/turf/open/floor/plating,
/area/shuttle/supply)
"S" = (
/obj/machinery/power/shuttle_engine/propulsion/burst/left{
	dir = 1
	},
/obj/structure/window/reinforced/plasma/spawner/directional/west,
/obj/structure/window/reinforced/plasma/spawner/directional/east,
/turf/open/floor/plating/airless,
/area/shuttle/supply)
"T" = (
/obj/machinery/door/airlock/titanium{
	name = "Supply Shuttle Airlock"
	},
/obj/effect/mapping_helpers/airlock/access/all/supply/general,
/obj/docking_port/mobile/supply{
	dir = 4
	},
/turf/open/floor/mineral/titanium/tiled/white,
/area/shuttle/supply)
"U" = (
/obj/effect/turf_decal/siding/thinplating_new/light/corner{
	dir = 1
	},
/obj/machinery/light/directional/east,
/turf/open/floor/mineral/titanium/white,
/area/shuttle/supply)
"X" = (
/turf/open/floor/mineral/titanium/tiled/white,
/area/shuttle/supply)
"Y" = (
/obj/machinery/door/airlock/titanium{
	name = "Supply Shuttle Airlock"
	},
/obj/effect/mapping_helpers/airlock/access/all/supply/general,
/turf/open/floor/mineral/titanium/tiled/white,
/area/shuttle/supply)
"Z" = (
/obj/machinery/conveyor{
	dir = 1;
	id = "QMLoad"
	},
/obj/machinery/light/directional/west,
/turf/open/floor/mineral/titanium/white,
/area/shuttle/supply)

(1,1,1) = {"
S
f
o
P
T
R
Y
t
o
o
u
s
"}
(2,1,1) = {"
o
d
Z
C
E
E
E
z
i
l
c
o
"}
(3,1,1) = {"
p
k
m
H
H
H
H
H
H
e
n
p
"}
(4,1,1) = {"
p
k
L
X
X
X
X
X
X
N
n
p
"}
(5,1,1) = {"
p
k
L
X
X
X
X
X
X
N
n
p
"}
(6,1,1) = {"
o
k
b
q
q
q
q
q
q
U
n
o
"}
(7,1,1) = {"
S
f
o
o
o
o
o
o
o
o
u
s
"}
