//MAP CONVERTED BY dmm2tgm.py THIS HEADER COMMENT PREVENTS RECONVERSION, DO NOT REMOVE
"a" = (
/obj/machinery/power/shuttle_engine/heater{
	dir = 4
	},
/obj/structure/window/reinforced/spawner/directional/north,
/obj/structure/window/reinforced/spawner/directional/south,
/turf/open/floor/plating/airless,
/area/space)
"l" = (
/obj/machinery/power/shuttle_engine/heater{
	dir = 4
	},
/obj/structure/window/reinforced/spawner/directional/south,
/obj/structure/window/reinforced/spawner/directional/north,
/turf/open/floor/plating/airless,
/area/space)
"m" = (
/obj/machinery/conveyor{
	dir = 5;
	id = "QMLoad2"
	},
/turf/open/floor/mineral/titanium/tiled/blue,
/area/space)
"n" = (
/obj/machinery/power/shuttle_engine/propulsion/right{
	dir = 4
	},
/obj/structure/window/reinforced/spawner/directional/north,
/obj/structure/window/reinforced/spawner/directional/south,
/turf/open/floor/plating/airless,
/area/space)
"v" = (
/obj/structure/plasticflaps,
/obj/machinery/conveyor{
	dir = 1;
	id = "QMLoad"
	},
/turf/open/floor/plating,
/area/space)
"w" = (
/obj/machinery/conveyor_switch/oneway{
	dir = 4
	},
/turf/open/floor/mineral/titanium/tiled/blue,
/area/space)
"z" = (
/turf/open/floor/mineral/titanium/tiled/blue,
/area/space)
"C" = (
/obj/machinery/conveyor{
	id = "QMLoad2"
	},
/obj/structure/plasticflaps,
/turf/open/floor/plating,
/area/space)
"H" = (
/obj/machinery/conveyor{
	dir = 8;
	id = "packageExternal"
	},
/turf/open/floor/mineral/titanium/tiled/blue,
/area/space)
"I" = (
/obj/machinery/conveyor{
	dir = 4;
	id = "garbage"
	},
/turf/open/floor/mineral/titanium/tiled/blue,
/area/space)
"N" = (
/obj/machinery/conveyor/inverted{
	dir = 6;
	id = "garbage"
	},
/turf/open/floor/mineral/titanium/tiled/blue,
/area/space)
"O" = (
/turf/closed/wall/mineral/titanium,
/area/space)
"V" = (
/obj/machinery/door/airlock/titanium{
	name = "Supply Shuttle Airlock"
	},
/turf/open/floor/plating,
/area/space)
"X" = (
/obj/machinery/door/airlock/titanium{
	name = "Supply Shuttle Airlock"
	},
/obj/effect/mapping_helpers/airlock/access/all/supply/general,
/obj/docking_port/mobile/supply{
	dir = 2
	},
/turf/open/floor/plating,
/area/space)

(1,1,1) = {"
O
O
O
O
O
"}
(2,1,1) = {"
O
z
z
H
O
"}
(3,1,1) = {"
O
z
z
H
O
"}
(4,1,1) = {"
O
z
w
N
v
"}
(5,1,1) = {"
O
z
z
z
X
"}
(6,1,1) = {"
O
z
z
z
O
"}
(7,1,1) = {"
O
z
z
z
V
"}
(8,1,1) = {"
O
z
w
m
C
"}
(9,1,1) = {"
O
z
z
I
O
"}
(10,1,1) = {"
l
z
z
I
a
"}
(11,1,1) = {"
n
O
O
O
n
"}
