//MAP CONVERTED BY dmm2tgm.py THIS HEADER COMMENT PREVENTS RECONVERSION, DO NOT REMOVE
"a" = (
/obj/effect/spawner/structure/window/shuttle,
/turf/open/floor/plating,
/area/shuttle/supply{
	dir = 8
	})
"b" = (
/obj/structure/window/reinforced{
	dir = 4
	},
/obj/effect/turf_decal/stripes/line{
	dir = 8
	},
/obj/effect/turf_decal/stripes/line{
	dir = 5
	},
/turf/open/floor/plating,
/area/shuttle/supply{
	dir = 8
	})
"c" = (
/obj/structure/shuttle/engine/heater,
/obj/structure/window/reinforced{
	dir = 8;
	layer = 2.9
	},
/obj/structure/window/reinforced{
	dir = 4
	},
/obj/structure/window/reinforced{
	dir = 1;
	layer = 2.9
	},
/obj/effect/turf_decal/stripes/line{
	dir = 4
	},
/obj/effect/turf_decal/stripes/line{
	dir = 8
	},
/turf/open/floor/plating,
/area/shuttle/supply{
	dir = 8
	})
"e" = (
/obj/effect/turf_decal/stripes/line{
	dir = 10
	},
/obj/machinery/conveyor_switch/oneway{
	dir = 8;
	id = "cargounload"
	},
/turf/open/floor/plasteel,
/area/shuttle/supply{
	dir = 8
	})
"f" = (
/obj/machinery/conveyor{
	dir = 1;
	id = "cargoload"
	},
/obj/effect/turf_decal/stripes/line{
	dir = 8
	},
/obj/effect/turf_decal/stripes/line{
	dir = 4
	},
/turf/open/floor/plasteel,
/area/shuttle/supply{
	dir = 8
	})
"i" = (
/obj/machinery/conveyor{
	dir = 1;
	id = "cargoload"
	},
/obj/effect/turf_decal/stripes/line{
	dir = 8
	},
/obj/effect/turf_decal/stripes/line{
	dir = 4
	},
/obj/machinery/light{
	dir = 4
	},
/turf/open/floor/plasteel,
/area/shuttle/supply{
	dir = 8
	})
"j" = (
/obj/structure/shuttle/engine/heater,
/obj/structure/window/reinforced{
	dir = 8;
	layer = 2.9
	},
/obj/structure/window/reinforced{
	dir = 4
	},
/obj/structure/window/reinforced{
	dir = 1;
	layer = 2.9
	},
/obj/effect/turf_decal/stripes/line{
	dir = 4
	},
/obj/effect/turf_decal/stripes/line{
	dir = 8
	},
/obj/effect/turf_decal/stripes/line{
	dir = 1
	},
/turf/open/floor/plating,
/area/shuttle/supply{
	dir = 8
	})
"l" = (
/obj/machinery/conveyor{
	dir = 4;
	id = "cargounload"
	},
/obj/effect/turf_decal/stripes/line,
/obj/effect/turf_decal/stripes/line{
	dir = 1
	},
/turf/open/floor/plasteel,
/area/shuttle/supply{
	dir = 8
	})
"m" = (
/obj/structure/shuttle/engine/propulsion,
/obj/structure/window/reinforced{
	dir = 8
	},
/obj/structure/window/reinforced{
	dir = 4
	},
/obj/effect/turf_decal/stripes/line{
	dir = 4
	},
/obj/effect/turf_decal/stripes/line{
	dir = 8
	},
/turf/open/floor/plating,
/area/shuttle/supply{
	dir = 8
	})
"n" = (
/obj/structure/shuttle/engine/propulsion{
	dir = 1
	},
/obj/structure/window/reinforced{
	dir = 8
	},
/obj/structure/window/reinforced{
	dir = 4
	},
/obj/effect/turf_decal/stripes/line{
	dir = 8
	},
/obj/effect/turf_decal/stripes/line{
	dir = 4
	},
/turf/open/floor/plating,
/area/shuttle/supply{
	dir = 8
	})
"p" = (
/obj/docking_port/mobile/supply{
	dir = 1;
	dwidth = 7
	},
/obj/machinery/door/airlock/titanium{
	name = "Supply Shuttle Airlock";
	req_access_txt = "31"
	},
/turf/open/floor/plasteel,
/area/shuttle/supply{
	dir = 8
	})
"q" = (
/obj/machinery/button/door{
	id = "QMLoaddoor2";
	layer = 4;
	name = "Shuttle Right Security Door";
	pixel_x = 7
	},
/obj/machinery/button/door{
	id = "QMLoaddoor1";
	layer = 4;
	name = "Shuttle Left Security Door";
	pixel_x = -7
	},
/turf/closed/wall/mineral/titanium,
/area/shuttle/supply{
	dir = 8
	})
"s" = (
/obj/effect/turf_decal/stripes/line{
	dir = 8
	},
/obj/effect/turf_decal/stripes/line{
	dir = 5
	},
/obj/structure/window/reinforced{
	dir = 8
	},
/turf/open/floor/plating,
/area/shuttle/supply{
	dir = 8
	})
"t" = (
/obj/effect/turf_decal/stripes/line{
	dir = 1
	},
/obj/machinery/conveyor_switch/oneway{
	id = "cargoload"
	},
/turf/open/floor/plasteel,
/area/shuttle/supply{
	dir = 8
	})
"u" = (
/obj/effect/turf_decal/stripes/line{
	dir = 4
	},
/obj/effect/turf_decal/stripes/line{
	dir = 10
	},
/obj/structure/window/reinforced{
	dir = 8
	},
/turf/open/floor/plating,
/area/shuttle/supply{
	dir = 8
	})
"w" = (
/obj/machinery/conveyor{
	dir = 8;
	id = "cargoload"
	},
/obj/effect/turf_decal/stripes/line{
	dir = 5
	},
/turf/open/floor/plasteel,
/area/shuttle/supply{
	dir = 8
	})
"x" = (
/obj/machinery/door/poddoor{
	id = "QMLoaddoor2";
	name = "Supply security door"
	},
/obj/machinery/conveyor{
	dir = 1;
	id = "cargoload"
	},
/turf/open/floor/plasteel,
/area/shuttle/supply{
	dir = 8
	})
"y" = (
/obj/machinery/door/airlock/titanium{
	name = "Supply Shuttle Airlock";
	req_access_txt = "31"
	},
/turf/open/floor/plasteel,
/area/shuttle/supply{
	dir = 8
	})
"z" = (
/obj/machinery/conveyor{
	dir = 4;
	id = "cargounload"
	},
/obj/effect/turf_decal/stripes/line{
	dir = 1
	},
/obj/effect/turf_decal/stripes/line,
/obj/machinery/light,
/turf/open/floor/plasteel,
/area/shuttle/supply{
	dir = 8
	})
"B" = (
/obj/effect/turf_decal/bot,
/obj/effect/turf_decal/loading_area{
	dir = 8
	},
/obj/machinery/light{
	dir = 1
	},
/turf/open/floor/mineral/titanium/blue,
/area/shuttle/supply{
	dir = 8
	})
"C" = (
/obj/structure/shuttle/engine/heater{
	dir = 1
	},
/obj/structure/window/reinforced{
	dir = 8
	},
/obj/structure/window/reinforced{
	dir = 4
	},
/obj/effect/turf_decal/stripes/line{
	dir = 8
	},
/obj/effect/turf_decal/stripes/line,
/obj/effect/turf_decal/stripes/line{
	dir = 4
	},
/obj/structure/window/reinforced,
/turf/open/floor/plating,
/area/shuttle/supply{
	dir = 8
	})
"D" = (
/obj/effect/turf_decal/bot,
/turf/open/floor/mineral/titanium/purple,
/area/shuttle/supply{
	dir = 8
	})
"E" = (
/obj/machinery/conveyor{
	dir = 4;
	id = "cargounload"
	},
/obj/effect/turf_decal/stripes/line{
	dir = 1
	},
/obj/effect/turf_decal/stripes/line,
/turf/open/floor/plasteel,
/area/shuttle/supply{
	dir = 8
	})
"F" = (
/obj/structure/window/reinforced{
	dir = 4
	},
/obj/effect/turf_decal/stripes/line{
	dir = 4
	},
/obj/effect/turf_decal/stripes/line{
	dir = 10
	},
/turf/open/floor/plating,
/area/shuttle/supply{
	dir = 8
	})
"G" = (
/obj/effect/turf_decal/stripes/line{
	dir = 1
	},
/turf/open/floor/plasteel,
/area/shuttle/supply{
	dir = 8
	})
"I" = (
/obj/effect/turf_decal/bot,
/obj/effect/turf_decal/loading_area{
	dir = 4
	},
/turf/open/floor/mineral/titanium/purple,
/area/shuttle/supply{
	dir = 8
	})
"J" = (
/obj/machinery/door/poddoor{
	id = "QMLoaddoor1";
	name = "Supply security door"
	},
/obj/machinery/conveyor{
	id = "cargounload"
	},
/turf/open/floor/plasteel,
/area/shuttle/supply{
	dir = 8
	})
"M" = (
/turf/closed/wall/mineral/titanium,
/area/shuttle/supply{
	dir = 8
	})
"N" = (
/obj/machinery/conveyor{
	dir = 8;
	id = "cargoload"
	},
/obj/effect/turf_decal/stripes/line{
	dir = 1
	},
/turf/open/floor/plasteel,
/area/shuttle/supply{
	dir = 8
	})
"O" = (
/obj/effect/turf_decal/bot,
/turf/open/floor/mineral/titanium/blue,
/area/shuttle/supply{
	dir = 8
	})
"R" = (
/obj/machinery/conveyor{
	dir = 6;
	id = "cargounload"
	},
/obj/effect/turf_decal/stripes/line{
	dir = 4
	},
/obj/effect/turf_decal/stripes/line,
/obj/effect/turf_decal/stripes/line{
	dir = 1
	},
/turf/open/floor/plasteel,
/area/shuttle/supply{
	dir = 8
	})
"T" = (
/obj/effect/turf_decal/stripes/line{
	dir = 8
	},
/turf/open/floor/plasteel,
/area/shuttle/supply{
	dir = 8
	})
"U" = (
/obj/effect/turf_decal/stripes/line{
	dir = 9
	},
/turf/open/floor/plasteel,
/area/shuttle/supply{
	dir = 8
	})
"V" = (
/turf/open/floor/plasteel,
/area/shuttle/supply{
	dir = 8
	})
"W" = (
/obj/effect/turf_decal/bot,
/obj/machinery/light{
	dir = 8
	},
/turf/open/floor/mineral/titanium/blue,
/area/shuttle/supply{
	dir = 8
	})

(1,1,1) = {"
j
m
F
a
b
n
C
"}
(2,1,1) = {"
M
W
D
D
V
I
M
"}
(3,1,1) = {"
M
O
D
D
V
z
M
"}
(4,1,1) = {"
M
O
O
D
V
E
M
"}
(5,1,1) = {"
a
O
O
D
V
E
M
"}
(6,1,1) = {"
a
V
V
V
V
l
M
"}
(7,1,1) = {"
a
B
U
T
e
R
J
"}
(8,1,1) = {"
a
N
G
V
V
V
p
"}
(9,1,1) = {"
M
N
G
V
V
V
q
"}
(10,1,1) = {"
M
N
t
V
V
V
y
"}
(11,1,1) = {"
M
w
f
f
i
f
x
"}
(12,1,1) = {"
c
m
u
a
s
n
C
"}
