//MAP CONVERTED BY dmm2tgm.py THIS HEADER COMMENT PREVENTS RECONVERSION, DO NOT REMOVE
"a" = (
/obj/machinery/power/shuttle_engine/heater{
	dir = 4
	},
/obj/structure/window/reinforced/spawner/directional/north,
/obj/structure/window/reinforced/spawner/directional/south,
/turf/open/floor/plating/airless,
/area/shuttle/supply)
"c" = (
/obj/machinery/conveyor{
	id = "QMLoad2";
	dir = 8
	},
/turf/open/floor/mineral/titanium/tiled/blue,
/area/shuttle/supply)
"l" = (
/obj/machinery/power/shuttle_engine/heater{
	dir = 4
	},
/obj/structure/window/reinforced/spawner/directional/south,
/obj/structure/window/reinforced/spawner/directional/north,
/turf/open/floor/plating/airless,
/area/shuttle/supply)
"m" = (
/obj/machinery/conveyor/inverted{
	dir = 5;
	id = "QMLoad2"
	},
/turf/open/floor/mineral/titanium/tiled/blue,
/area/shuttle/supply)
"n" = (
/obj/machinery/power/shuttle_engine/propulsion/right{
	dir = 4
	},
/obj/structure/window/reinforced/spawner/directional/north,
/obj/structure/window/reinforced/spawner/directional/south,
/turf/open/floor/plating/airless,
/area/shuttle/supply)
"v" = (
/obj/structure/plasticflaps,
/obj/machinery/conveyor{
	dir = 1;
	id = "QMLoad"
	},
/turf/open/floor/plating,
/area/shuttle/supply)
"w" = (
/obj/machinery/conveyor_switch/oneway{
	dir = 4;
	id = "QMLoad"
	},
/turf/open/floor/mineral/titanium/tiled/blue,
/area/shuttle/supply)
"z" = (
/turf/open/floor/mineral/titanium/tiled/blue,
/area/shuttle/supply)
"C" = (
/obj/machinery/conveyor{
	id = "QMLoad2"
	},
/obj/structure/plasticflaps,
/turf/open/floor/plating,
/area/shuttle/supply)
"E" = (
/obj/machinery/conveyor_switch/oneway{
	dir = 4;
	id = "QMLoad2"
	},
/turf/open/floor/mineral/titanium/tiled/blue,
/area/shuttle/supply)
"H" = (
/obj/machinery/conveyor{
	dir = 8;
	id = "QMLoad"
	},
/turf/open/floor/mineral/titanium/tiled/blue,
/area/shuttle/supply)
"I" = (
/obj/machinery/conveyor{
	dir = 8;
	id = "QMLoad2"
	},
/turf/open/floor/mineral/titanium/tiled/blue,
/area/shuttle/supply)
"N" = (
/obj/machinery/conveyor/inverted{
	dir = 6;
	id = "QMLoad"
	},
/turf/open/floor/mineral/titanium/tiled/blue,
/area/shuttle/supply)
"O" = (
/turf/closed/wall/mineral/titanium,
/area/shuttle/supply)
"V" = (
/obj/machinery/door/airlock/titanium{
	name = "Supply Shuttle Airlock"
	},
/turf/open/floor/plating,
/area/shuttle/supply)
"X" = (
/obj/machinery/door/airlock/titanium{
	name = "Supply Shuttle Airlock"
	},
/obj/docking_port/mobile/supply{
	dir = 1
	},
/turf/open/floor/plating,
/area/shuttle/supply)

(1,1,1) = {"
O
O
O
O
O
"}
(2,1,1) = {"
O
z
z
H
O
"}
(3,1,1) = {"
O
z
z
H
O
"}
(4,1,1) = {"
O
z
w
N
v
"}
(5,1,1) = {"
O
z
z
z
X
"}
(6,1,1) = {"
O
z
z
z
O
"}
(7,1,1) = {"
O
z
z
z
V
"}
(8,1,1) = {"
O
z
E
m
C
"}
(9,1,1) = {"
O
z
z
I
O
"}
(10,1,1) = {"
l
z
z
c
a
"}
(11,1,1) = {"
n
O
O
O
n
"}
