//MAP CONVERTED BY dmm2tgm.py THIS HEADER COMMENT PREVENTS RECONVERSION, DO NOT REMOVE
"b" = (
/turf/closed/wall/mineral/titanium,
/area/shuttle/supply)
"d" = (
/obj/machinery/door/airlock/titanium{
	name = "Supply Shuttle Airlock";
	req_access_txt = "31"
	},
/turf/open/floor/plating,
/area/shuttle/supply)
"e" = (
/turf/open/floor/mineral/titanium/blue,
/area/shuttle/supply)
"f" = (
/obj/structure/shuttle/engine/heater,
/obj/structure/window/reinforced{
	dir = 1
	},
/obj/structure/window/reinforced{
	dir = 4
	},
/turf/open/floor/plating/airless,
/area/shuttle/supply)
"g" = (
/obj/machinery/conveyor{
	id = "QMLoad"
	},
/turf/open/floor/mineral/titanium/purple,
/area/shuttle/supply)
"h" = (
/obj/machinery/light{
	dir = 4
	},
/turf/open/floor/mineral/titanium/white,
/area/shuttle/supply)
"i" = (
/turf/open/floor/mineral/titanium/purple,
/area/shuttle/supply)
"j" = (
/obj/structure/shuttle/engine/heater,
/obj/structure/window/reinforced{
	dir = 1
	},
/obj/structure/window/reinforced{
	dir = 8
	},
/turf/open/floor/plating/airless,
/area/shuttle/supply)
"k" = (
/obj/machinery/conveyor_switch/oneway{
	id = "QMLoad2"
	},
/turf/open/floor/mineral/titanium/blue,
/area/shuttle/supply)
"l" = (
/obj/machinery/conveyor{
	id = "QMLoad2"
	},
/turf/open/floor/mineral/titanium/blue,
/area/shuttle/supply)
"q" = (
/obj/structure/shuttle/engine/propulsion/burst/left,
/obj/structure/window/reinforced{
	dir = 4
	},
/obj/structure/window/reinforced,
/turf/open/floor/plating/airless,
/area/shuttle/supply)
"t" = (
/obj/machinery/conveyor_switch/oneway{
	dir = 1;
	id = "QMLoad"
	},
/turf/open/floor/mineral/titanium/purple,
/area/shuttle/supply)
"u" = (
/obj/structure/shuttle/engine/propulsion/burst/left,
/obj/structure/window/reinforced{
	dir = 8
	},
/obj/structure/window/reinforced,
/turf/open/floor/plating/airless,
/area/shuttle/supply)
"v" = (
/obj/machinery/conveyor{
	dir = 8;
	id = "QMLoad"
	},
/turf/open/floor/plating,
/area/shuttle/supply)
"w" = (
/obj/machinery/light{
	dir = 1
	},
/turf/open/floor/mineral/titanium/purple,
/area/shuttle/supply)
"x" = (
/obj/machinery/light{
	dir = 8
	},
/turf/open/floor/mineral/titanium/purple,
/area/shuttle/supply)
"F" = (
/obj/structure/window/reinforced{
	dir = 8
	},
/obj/structure/shuttle/engine/propulsion/burst/left,
/obj/structure/window/reinforced,
/turf/open/floor/plating/airless,
/area/shuttle/supply)
"K" = (
/obj/machinery/door/airlock/titanium{
	name = "Supply Shuttle Airlock";
	req_access_txt = "31"
	},
/obj/docking_port/mobile/supply{
	dir = 4
	},
/turf/open/floor/plating,
/area/shuttle/supply)
"L" = (
/turf/open/floor/mineral/titanium/white,
/area/shuttle/supply)
"N" = (
/obj/machinery/conveyor{
	dir = 4;
	id = "QMLoad2"
	},
/turf/open/floor/mineral/titanium/blue,
/area/shuttle/supply)
"O" = (
/obj/structure/window/reinforced{
	dir = 8
	},
/obj/structure/shuttle/engine/heater,
/obj/structure/window/reinforced{
	dir = 1
	},
/turf/open/floor/plating/airless,
/area/shuttle/supply)
"S" = (
/obj/machinery/conveyor{
	dir = 6;
	id = "QMLoad2"
	},
/turf/open/floor/mineral/titanium/blue,
/area/shuttle/supply)
"T" = (
/obj/effect/spawner/structure/window/reinforced,
/turf/open/floor/plating,
/area/shuttle/supply)
"U" = (
/obj/structure/shuttle/engine/heater,
/obj/structure/window/reinforced{
	dir = 4
	},
/obj/structure/window/reinforced{
	dir = 1
	},
/turf/open/floor/plating/airless,
/area/shuttle/supply)
"Y" = (
/obj/machinery/conveyor{
	dir = 10;
	id = "QMLoad"
	},
/turf/open/floor/mineral/titanium/purple,
/area/shuttle/supply)

(1,1,1) = {"
b
f
q
v
K
T
d
N
U
q
b
b
"}
(2,1,1) = {"
b
g
g
Y
i
x
e
S
l
l
l
b
"}
(3,1,1) = {"
b
i
t
L
L
L
L
L
L
k
e
b
"}
(4,1,1) = {"
b
w
i
L
L
L
L
L
L
e
e
b
"}
(5,1,1) = {"
b
i
i
L
L
L
L
L
L
e
e
b
"}
(6,1,1) = {"
b
i
i
L
L
h
L
L
L
e
e
b
"}
(7,1,1) = {"
b
j
u
b
b
b
b
b
O
F
b
b
"}
