//MAP CONVERTED BY dmm2tgm.py THIS HEADER COMMENT PREVENTS RECONVERSION, DO NOT REMOVE
"c" = (
/obj/machinery/conveyor{
	dir = 9;
	id = "QMLoad2"
	},
/turf/open/floor/mineral/titanium/tiled/white,
/area/shuttle/supply)
"d" = (
/obj/machinery/conveyor{
	dir = 5;
	id = "QMLoad"
	},
/turf/open/floor/mineral/titanium/tiled/white,
/area/shuttle/supply)
"e" = (
/obj/machinery/conveyor_switch/oneway{
	id = "QMLoad2"
	},
/turf/open/floor/mineral/titanium/tiled/white,
/area/shuttle/supply)
"f" = (
/obj/structure/window/reinforced/spawner/directional/east,
/obj/structure/window/reinforced/spawner/directional/south,
/obj/structure/window/reinforced/spawner/directional/west,
/obj/machinery/power/shuttle_engine/heater{
	dir = 1
	},
/turf/open/floor/plating/airless,
/area/shuttle/supply)
"k" = (
/obj/machinery/conveyor{
	dir = 4;
	id = "garbage"
	},
/turf/open/floor/mineral/titanium/tiled/white,
/area/shuttle/supply)
"l" = (
/obj/machinery/conveyor{
	dir = 1;
	id = "QMLoad2"
	},
/turf/open/floor/mineral/titanium/tiled/white,
/area/shuttle/supply)
"m" = (
/obj/machinery/conveyor_switch/oneway{
	dir = 1;
	id = "QMLoad"
	},
/turf/open/floor/mineral/titanium/tiled/white,
/area/shuttle/supply)
"n" = (
/obj/machinery/conveyor{
	dir = 8;
	id = "QMLoad2"
	},
/turf/open/floor/mineral/titanium/tiled/white,
/area/shuttle/supply)
"o" = (
/turf/closed/wall/mineral/titanium,
/area/shuttle/supply)
"r" = (
/obj/machinery/power/shuttle_engine/propulsion/burst/left,
/obj/structure/window/reinforced/spawner/directional/west,
/obj/structure/window/reinforced/spawner/directional/east,
/turf/open/floor/plating/airless,
/area/shuttle/supply)
"s" = (
/obj/structure/window/reinforced/spawner/directional/east,
/obj/structure/window/reinforced/spawner/directional/west,
/obj/machinery/power/shuttle_engine/propulsion/burst/left,
/turf/open/floor/plating/airless,
/area/shuttle/supply)
"t" = (
/obj/machinery/conveyor{
	dir = 8;
	id = "QMLoad2"
	},
/obj/structure/plasticflaps/opaque,
/turf/open/floor/mineral/titanium/blue,
/area/shuttle/supply)
"u" = (
/obj/structure/window/reinforced/spawner/directional/east,
/obj/structure/window/reinforced/spawner/directional/north,
/obj/machinery/power/shuttle_engine/heater,
/obj/structure/window/reinforced/spawner/directional/west,
/turf/open/floor/plating/airless,
/area/shuttle/supply)
"z" = (
/obj/machinery/conveyor/inverted{
	dir = 6;
	id = "QMLoad2"
	},
/turf/open/floor/mineral/titanium/tiled/white,
/area/shuttle/supply)
"A" = (
/obj/machinery/light/directional/east,
/turf/open/floor/mineral/titanium/tiled/white,
/area/shuttle/supply)
"C" = (
/obj/machinery/conveyor/inverted{
	dir = 10;
	id = "QMLoad"
	},
/turf/open/floor/mineral/titanium/tiled/white,
/area/shuttle/supply)
"D" = (
/obj/machinery/power/shuttle_engine/heater,
/obj/structure/window/reinforced/spawner/directional/west,
/obj/structure/window/reinforced/spawner/directional/north,
/obj/structure/window/reinforced/spawner/directional/east,
/turf/open/floor/plating/airless,
/area/shuttle/supply)
"F" = (
/obj/machinery/conveyor{
	dir = 6;
	id = "QMLoad"
	},
/turf/open/floor/mineral/titanium/tiled/white,
/area/shuttle/supply)
"J" = (
/obj/machinery/conveyor{
	dir = 4;
	id = "QMLoad"
	},
/turf/open/floor/mineral/titanium/tiled/white,
/area/shuttle/supply)
"K" = (
/obj/machinery/light/directional/west,
/turf/open/floor/mineral/titanium/tiled/white,
/area/shuttle/supply)
"P" = (
/obj/machinery/conveyor{
	dir = 4;
	id = "QMLoad"
	},
/obj/structure/plasticflaps/opaque,
/turf/open/floor/mineral/titanium/purple,
/area/shuttle/supply)
"Q" = (
/obj/machinery/light/directional/north,
/obj/machinery/conveyor{
	dir = 4;
	id = "QMLoad"
	},
/turf/open/floor/mineral/titanium/tiled/white,
/area/shuttle/supply)
"R" = (
/obj/effect/spawner/structure/window/reinforced,
/turf/open/floor/plating,
/area/shuttle/supply)
"S" = (
/obj/structure/window/reinforced/spawner/directional/east,
/obj/structure/window/reinforced/spawner/directional/west,
/obj/machinery/power/shuttle_engine/propulsion/burst/left{
	dir = 1
	},
/turf/open/floor/plating/airless,
/area/shuttle/supply)
"T" = (
/obj/machinery/door/airlock/titanium{
	name = "Supply Shuttle Airlock"
	},
/obj/effect/mapping_helpers/airlock/access/all/supply/general,
/obj/docking_port/mobile/supply{
	dir = 4
	},
/turf/open/floor/plating,
/area/shuttle/supply)
"W" = (
/obj/machinery/light/directional/south,
/obj/machinery/conveyor{
	dir = 8;
	id = "QMLoad2"
	},
/turf/open/floor/mineral/titanium/tiled/white,
/area/shuttle/supply)
"X" = (
/turf/open/floor/mineral/titanium/tiled/white,
/area/shuttle/supply)
"Y" = (
/obj/machinery/door/airlock/titanium{
	name = "Supply Shuttle Airlock"
	},
/obj/effect/mapping_helpers/airlock/access/all/supply/general,
/turf/open/floor/plating,
/area/shuttle/supply)
"Z" = (
/obj/machinery/conveyor{
	dir = 1;
	id = "QMLoad"
	},
/turf/open/floor/mineral/titanium/tiled/white,
/area/shuttle/supply)

(1,1,1) = {"
S
f
o
P
T
R
Y
t
o
o
u
s
"}
(2,1,1) = {"
o
d
Z
C
K
X
X
z
l
l
c
o
"}
(3,1,1) = {"
o
k
m
X
X
X
X
X
X
e
n
o
"}
(4,1,1) = {"
o
Q
X
X
X
X
X
X
X
X
W
o
"}
(5,1,1) = {"
o
J
X
X
X
X
X
X
X
X
n
o
"}
(6,1,1) = {"
o
F
X
X
X
A
X
X
X
X
n
o
"}
(7,1,1) = {"
S
f
o
o
o
o
o
o
o
o
D
r
"}
