//MAP CONVERTED BY dmm2tgm.py THIS HEADER COMMENT PREVENTS RECONVERSION, DO NOT REMOVE
"al" = (
/obj/machinery/computer/records/medical{
	dir = 8
	},
/turf/open/floor/iron/dark/herringbone,
/area/shuttle/escape)
"at" = (
/obj/structure/table/reinforced,
/obj/item/restraints/handcuffs{
	pixel_y = 6
	},
/obj/item/restraints/handcuffs{
	pixel_y = 3
	},
/obj/item/restraints/handcuffs,
/turf/open/floor/mineral/plastitanium/red,
/area/shuttle/escape/brig)
"az" = (
/turf/open/floor/iron/dark/herringbone,
/area/shuttle/escape)
"aW" = (
/obj/structure/flora/bush/lavendergrass/style_random,
/turf/open/floor/grass,
/area/shuttle/escape)
"aZ" = (
/obj/effect/turf_decal/siding/thinplating,
/obj/effect/turf_decal/trimline/yellow/corner{
	dir = 1
	},
/turf/open/floor/mineral/titanium/white,
/area/shuttle/escape)
"bo" = (
/obj/effect/turf_decal/siding/thinplating{
	dir = 6
	},
/turf/open/floor/mineral/titanium/white,
/area/shuttle/escape)
"bt" = (
/turf/closed/wall/mineral/plastitanium,
/area/shuttle/escape)
"bB" = (
/obj/machinery/light/small/directional/east,
/turf/open/floor/wood,
/area/shuttle/escape)
"cc" = (
/obj/structure/window/reinforced/spawner/directional/north,
/obj/machinery/power/shuttle_engine/heater,
/turf/open/floor/plating/airless,
/area/shuttle/escape)
"cf" = (
/turf/open/floor/mineral/titanium/white,
/area/shuttle/escape)
"cu" = (
/obj/effect/turf_decal/stripes/line,
/obj/machinery/mech_bay_recharge_port{
	dir = 8
	},
/obj/machinery/light/small/directional/north,
/turf/open/floor/iron,
/area/shuttle/escape)
"cM" = (
/obj/structure/table/reinforced,
/obj/item/storage/medkit/o2,
/turf/open/floor/mineral/titanium/blue,
/area/shuttle/escape)
"dk" = (
/obj/effect/spawner/structure/window/reinforced/shuttle,
/turf/open/floor/plating,
/area/shuttle/escape)
"dF" = (
/obj/structure/table/reinforced,
/obj/machinery/recharger,
/obj/item/restraints/handcuffs,
/turf/open/floor/iron/dark/herringbone,
/area/shuttle/escape)
"dQ" = (
/obj/structure/table/wood,
/obj/item/storage/fancy/coffee_condi_display{
	pixel_x = -4;
	pixel_y = 4
	},
/obj/item/reagent_containers/cup/bottle/syrup_bottle/caramel{
	pixel_x = 9;
	pixel_y = 16
	},
/obj/item/reagent_containers/cup/bottle/syrup_bottle/korta_nectar{
	pixel_x = 9;
	pixel_y = 9
	},
/obj/item/reagent_containers/cup/bottle/syrup_bottle/liqueur{
	pixel_x = 9;
	pixel_y = 2
	},
/obj/effect/turf_decal/siding/wood{
	dir = 4
	},
/obj/structure/window/reinforced/spawner/directional/east,
/turf/open/floor/wood,
/area/shuttle/escape)
"ef" = (
/turf/closed/wall/mineral/titanium,
/area/shuttle/escape)
"ej" = (
/obj/structure/railing/corner{
	dir = 4
	},
/turf/open/floor/mineral/titanium/tiled,
/area/shuttle/escape)
"eo" = (
/obj/structure/railing/corner{
	dir = 1
	},
/turf/open/floor/mineral/titanium/tiled,
/area/shuttle/escape)
"eC" = (
/obj/structure/chair/comfy/shuttle,
/turf/open/floor/mineral/titanium/white,
/area/shuttle/escape)
"fj" = (
/obj/effect/turf_decal/trimline/blue/line{
	dir = 4
	},
/turf/open/floor/mineral/titanium/white,
/area/shuttle/escape)
"fp" = (
/obj/effect/turf_decal/fulp/floor_directions/port/directional,
/turf/open/floor/mineral/titanium/white,
/area/shuttle/escape)
"fO" = (
/obj/machinery/light/directional/east,
/obj/effect/turf_decal/siding/thinplating{
	dir = 8
	},
/obj/machinery/status_display/evac/directional/east,
/turf/open/floor/mineral/titanium/white,
/area/shuttle/escape)
"gc" = (
/obj/structure/chair/comfy/shuttle{
	dir = 4
	},
/turf/open/floor/mineral/titanium/tiled,
/area/shuttle/escape)
"gh" = (
/obj/effect/turf_decal/siding/wood{
	dir = 5
	},
/obj/structure/musician/piano/minimoog,
/turf/open/floor/wood/large,
/area/shuttle/escape)
"gp" = (
/obj/structure/table/wood,
/obj/machinery/coffeemaker/impressa,
/obj/machinery/light/directional/south,
/turf/open/floor/wood,
/area/shuttle/escape)
"gr" = (
/obj/structure/flora/bush/lavendergrass/style_random,
/obj/structure/flora/bush/fullgrass/style_random,
/turf/open/floor/grass,
/area/shuttle/escape)
"gv" = (
/obj/structure/flora/bush/flowers_yw/style_random,
/obj/item/food/grown/apple{
	pixel_x = -5
	},
/obj/item/food/grown/apple{
	pixel_x = 2;
	pixel_y = 3
	},
/obj/item/food/grown/apple{
	pixel_x = 1;
	pixel_y = -6
	},
/turf/open/floor/grass,
/area/shuttle/escape)
"gH" = (
/obj/machinery/newscaster/directional/south,
/turf/open/floor/iron/dark/herringbone,
/area/shuttle/escape)
"gJ" = (
/obj/machinery/light/directional/east,
/obj/structure/table/reinforced,
/obj/machinery/recharger,
/turf/open/floor/mineral/plastitanium/red,
/area/shuttle/escape/brig)
"gT" = (
/obj/structure/table/wood,
/obj/structure/window/reinforced/spawner/directional/south,
/obj/item/storage/box/coffeepack{
	pixel_x = 4;
	pixel_y = 2
	},
/obj/item/storage/box/coffeepack/robusta{
	pixel_x = -4;
	pixel_y = 3
	},
/turf/open/floor/wood,
/area/shuttle/escape)
"hl" = (
/obj/effect/turf_decal/siding/wood{
	dir = 4
	},
/obj/effect/turf_decal/loading_area/white{
	dir = 4
	},
/turf/open/floor/wood/large,
/area/shuttle/escape)
"hE" = (
/obj/effect/turf_decal/siding/thinplating/corner{
	dir = 1
	},
/obj/effect/turf_decal/trimline/blue/line{
	dir = 4
	},
/turf/open/floor/mineral/titanium/white,
/area/shuttle/escape)
"hW" = (
/obj/structure/railing{
	dir = 6
	},
/obj/structure/table/reinforced,
/obj/item/storage/toolbox/fishing,
/turf/open/floor/mineral/titanium/tiled,
/area/shuttle/escape)
"ie" = (
/obj/structure/table/wood,
/obj/machinery/microwave,
/turf/open/floor/wood,
/area/shuttle/escape)
"iv" = (
/obj/structure/table/wood,
/obj/structure/desk_bell{
	pixel_x = 7;
	pixel_y = 9
	},
/obj/effect/turf_decal/siding/wood{
	dir = 4
	},
/obj/machinery/door/window/left/directional/east{
	name = "Shuttle Coffee Shop";
	req_access = list("bar")
	},
/turf/open/floor/wood,
/area/shuttle/escape)
"iS" = (
/obj/structure/chair/office{
	dir = 1
	},
/turf/open/floor/iron/dark/herringbone,
/area/shuttle/escape)
"jr" = (
/obj/structure/table/wood,
/obj/structure/window/reinforced/spawner/directional/south,
/obj/structure/window/reinforced/spawner/directional/east,
/obj/item/storage/box/donkpockets,
/turf/open/floor/wood,
/area/shuttle/escape)
"jv" = (
/obj/effect/turf_decal/stripes/line,
/obj/machinery/computer/mech_bay_power_console,
/turf/open/floor/iron,
/area/shuttle/escape)
"kd" = (
/obj/machinery/computer/operating{
	dir = 1
	},
/turf/open/floor/mineral/titanium/blue,
/area/shuttle/escape)
"kt" = (
/obj/machinery/computer/records/security{
	dir = 4
	},
/turf/open/floor/iron/dark/herringbone,
/area/shuttle/escape)
"kE" = (
/obj/structure/table/reinforced,
/obj/machinery/light/directional/south,
/obj/effect/turf_decal/siding/thinplating_new{
	dir = 1
	},
/turf/open/floor/mineral/titanium/tiled,
/area/shuttle/escape)
"kJ" = (
/obj/machinery/door/airlock/security/glass{
	name = "Shuttle Brig"
	},
/obj/effect/mapping_helpers/airlock/access/all/command/general,
/turf/open/floor/mineral/plastitanium,
/area/shuttle/escape/brig)
"kM" = (
/obj/machinery/door/airlock/shuttle{
	name = "Emergency Shuttle Airlock"
	},
/obj/docking_port/mobile/emergency{
	name = "Theia emergency shuttle"
	},
/turf/open/floor/mineral/titanium/white,
/area/shuttle/escape)
"ll" = (
/obj/structure/chair/comfy/shuttle{
	dir = 8
	},
/turf/open/floor/mineral/plastitanium/red,
/area/shuttle/escape/brig)
"ls" = (
/turf/template_noop,
/area/template_noop)
"lu" = (
/obj/effect/turf_decal/siding/thinplating/corner{
	dir = 1
	},
/obj/effect/turf_decal/fulp/floor_directions/starboard/directional{
	base_pixel_x = 16;
	pixel_x = 16
	},
/turf/open/floor/mineral/titanium/white,
/area/shuttle/escape)
"lJ" = (
/obj/effect/turf_decal/siding/thinplating/corner{
	dir = 8
	},
/obj/effect/turf_decal/fulp/floor_directions/fore/directional{
	pixel_x = 16;
	base_pixel_x = 16
	},
/turf/open/floor/mineral/titanium/white,
/area/shuttle/escape)
"ng" = (
/obj/machinery/door/airlock/shuttle{
	name = "Emergency Shuttle Airlock"
	},
/turf/open/floor/mineral/titanium/white,
/area/shuttle/escape)
"od" = (
/obj/structure/railing{
	dir = 8
	},
/obj/structure/chair/sofa/bench{
	dir = 4
	},
/turf/open/floor/mineral/titanium/tiled,
/area/shuttle/escape)
"ov" = (
/turf/open/floor/grass,
/area/shuttle/escape)
"oz" = (
/obj/structure/chair/comfy/shuttle{
	dir = 8
	},
/obj/effect/turf_decal/siding/thinplating_new{
	dir = 1
	},
/turf/open/floor/mineral/titanium/tiled,
/area/shuttle/escape)
"oA" = (
/obj/effect/turf_decal/siding/thinplating,
/obj/effect/turf_decal/trimline/yellow/line{
	dir = 1
	},
/turf/open/floor/mineral/titanium/white,
/area/shuttle/escape)
"oN" = (
/turf/closed/wall/mineral/plastitanium/nodiagonal,
/area/shuttle/escape)
"pu" = (
/obj/machinery/light/directional/east,
/obj/structure/tank_dispenser/oxygen,
/obj/structure/railing{
	dir = 1
	},
/turf/open/floor/mineral/titanium/yellow,
/area/shuttle/escape)
"pB" = (
/obj/structure/chair/comfy/shuttle,
/obj/structure/extinguisher_cabinet/directional/north,
/turf/open/floor/mineral/titanium/white,
/area/shuttle/escape)
"qa" = (
/obj/machinery/power/shuttle_engine/heater,
/obj/structure/window/reinforced/spawner/directional/north,
/turf/open/floor/plating/airless,
/area/shuttle/escape)
"qo" = (
/obj/effect/turf_decal/trimline/dark_blue/warning{
	dir = 1
	},
/turf/open/floor/mineral/titanium/white,
/area/shuttle/escape)
"qM" = (
/obj/structure/flora/bush/fullgrass/style_random,
/obj/structure/flora/bush/flowers_br/style_random,
/obj/machinery/light/directional/north,
/mob/living/basic/pony,
/turf/open/floor/grass,
/area/shuttle/escape)
"rs" = (
/obj/machinery/computer/emergency_shuttle,
/turf/open/floor/iron/dark/herringbone,
/area/shuttle/escape)
"sf" = (
/obj/effect/turf_decal/trimline/red/corner{
	dir = 4
	},
/turf/open/floor/mineral/titanium/white,
/area/shuttle/escape)
"sy" = (
/obj/structure/table/wood,
/obj/structure/window/reinforced/spawner/directional/north,
/obj/structure/window/reinforced/spawner/directional/east,
/obj/structure/displaycase/forsale,
/turf/open/floor/wood,
/area/shuttle/escape)
"sG" = (
/obj/structure/flora/bush/fullgrass/style_random,
/obj/structure/flora/bush/lavendergrass/style_random,
/turf/open/floor/grass,
/area/shuttle/escape)
"td" = (
/obj/effect/turf_decal/siding/thinplating{
	dir = 4
	},
/turf/open/floor/mineral/titanium/white,
/area/shuttle/escape)
"tp" = (
/obj/item/storage/medkit/brute{
	pixel_y = 8
	},
/obj/structure/table/reinforced,
/obj/item/storage/medkit/fire{
	pixel_y = -12
	},
/turf/open/floor/mineral/titanium/blue,
/area/shuttle/escape)
"ts" = (
/obj/effect/turf_decal/siding/wood{
	dir = 6
	},
/obj/effect/turf_decal/bot_white,
/turf/open/floor/wood/large,
/area/shuttle/escape)
"tu" = (
/obj/machinery/door/airlock/command/glass{
	name = "Shuttle Flight Deck"
	},
/obj/effect/mapping_helpers/airlock/access/all/command/general,
/obj/effect/mapping_helpers/airlock/cyclelink_helper_multi{
	cycle_id = "shuttle-flight-deck"
	},
/obj/effect/turf_decal/siding/wood,
/turf/open/floor/wood,
/area/shuttle/escape)
"tC" = (
/obj/structure/table/optable,
/obj/machinery/light/small/directional/south,
/turf/open/floor/mineral/titanium/blue,
/area/shuttle/escape)
"tU" = (
/obj/structure/rack,
/obj/machinery/light/directional/north,
/obj/item/clothing/shoes/sneakers/black,
/obj/item/clothing/under/color/black,
/obj/item/clothing/suit/apron/chef{
	color = "#00a62e";
	name = "Spacebucks Coffee apron"
	},
/obj/item/clothing/head/soft/black,
/turf/open/floor/wood,
/area/shuttle/escape)
"uk" = (
/obj/effect/turf_decal/siding/thinplating{
	dir = 8
	},
/obj/structure/extinguisher_cabinet/directional/east,
/turf/open/floor/mineral/titanium/white,
/area/shuttle/escape)
"uq" = (
/obj/effect/turf_decal/siding/thinplating{
	dir = 8
	},
/obj/effect/turf_decal/siding/thinplating/corner{
	dir = 8
	},
/obj/effect/turf_decal/trimline/yellow/line{
	dir = 4
	},
/turf/open/floor/mineral/titanium/white,
/area/shuttle/escape)
"uy" = (
/turf/closed/wall/mineral/titanium/nodiagonal,
/area/shuttle/escape)
"uT" = (
/obj/machinery/shower/directional/east,
/obj/effect/turf_decal/box/white,
/obj/item/soap/nanotrasen,
/obj/item/bikehorn/rubberducky,
/turf/open/floor/mineral/titanium/blue,
/area/shuttle/escape)
"vg" = (
/obj/structure/flora/bush/flowers_yw/style_random,
/obj/item/statuebust,
/turf/open/floor/grass,
/area/shuttle/escape)
"vD" = (
/obj/effect/turf_decal/siding/thinplating{
	dir = 1
	},
/turf/open/floor/mineral/titanium/white,
/area/shuttle/escape)
"vL" = (
/obj/structure/railing/corner{
	dir = 8
	},
/turf/open/floor/mineral/titanium/tiled,
/area/shuttle/escape)
"wp" = (
/obj/machinery/stasis,
/turf/open/floor/mineral/titanium/blue,
/area/shuttle/escape)
"wB" = (
/obj/structure/table/reinforced,
/obj/item/defibrillator/loaded,
/obj/machinery/light/directional/east,
/turf/open/floor/mineral/titanium/blue,
/area/shuttle/escape)
"wR" = (
/obj/machinery/fishing_portal_generator,
/obj/structure/railing{
	dir = 5
	},
/turf/open/floor/mineral/titanium/tiled,
/area/shuttle/escape)
"xo" = (
/obj/effect/turf_decal/stripes/line,
/obj/effect/turf_decal/box/red,
/obj/structure/reagent_dispensers/fueltank,
/turf/open/floor/iron,
/area/shuttle/escape)
"xH" = (
/obj/effect/turf_decal/fulp/floor_directions/aft/directional,
/turf/open/floor/mineral/titanium/white,
/area/shuttle/escape)
"xW" = (
/obj/structure/railing{
	dir = 4
	},
/obj/structure/chair/sofa/bench/right{
	dir = 8
	},
/turf/open/floor/mineral/titanium/tiled,
/area/shuttle/escape)
"yi" = (
/turf/open/floor/mineral/plastitanium/red,
/area/shuttle/escape/brig)
"yl" = (
/obj/structure/railing,
/obj/structure/chair/sofa/bench/left{
	dir = 1
	},
/turf/open/floor/mineral/titanium/tiled,
/area/shuttle/escape)
"ys" = (
/obj/structure/chair/comfy/shuttle,
/turf/open/floor/mineral/plastitanium/red,
/area/shuttle/escape/brig)
"yv" = (
/obj/machinery/light/directional/north,
/obj/structure/table/reinforced,
/obj/item/storage/fancy/donut_box,
/turf/open/floor/iron/dark/herringbone,
/area/shuttle/escape)
"yC" = (
/obj/structure/flora/tree/cherry,
/turf/open/floor/grass,
/area/shuttle/escape)
"zf" = (
/obj/effect/turf_decal/delivery,
/obj/structure/closet/crate/internals,
/obj/item/tank/internals/emergency_oxygen{
	pixel_x = 3
	},
/obj/item/tank/internals/emergency_oxygen{
	pixel_x = 3
	},
/obj/item/tank/internals/emergency_oxygen{
	pixel_x = 3
	},
/obj/item/tank/internals/emergency_oxygen{
	pixel_x = 3
	},
/obj/item/clothing/mask/breath{
	pixel_x = -3;
	pixel_y = -3
	},
/obj/item/clothing/mask/breath{
	pixel_x = -3;
	pixel_y = -3
	},
/obj/item/clothing/mask/breath{
	pixel_x = -3;
	pixel_y = -3
	},
/obj/item/clothing/mask/breath{
	pixel_x = -3;
	pixel_y = -3
	},
/turf/open/floor/mineral/titanium,
/area/shuttle/escape)
"zg" = (
/obj/effect/turf_decal/siding/wood{
	dir = 4
	},
/obj/effect/turf_decal/bot_white,
/turf/open/floor/wood/large,
/area/shuttle/escape)
"zr" = (
/obj/effect/turf_decal/trimline/blue/corner{
	dir = 4
	},
/turf/open/floor/mineral/titanium/white,
/area/shuttle/escape)
"zB" = (
/turf/open/floor/mineral/titanium/tiled/white,
/area/shuttle/escape)
"Ai" = (
/obj/machinery/door/window/right/directional/north{
	req_access = list("bar");
	name = "Shuttle Coffee Shop"
	},
/obj/effect/turf_decal/siding/wood{
	dir = 1
	},
/turf/open/floor/wood,
/area/shuttle/escape)
"Al" = (
/obj/machinery/light/directional/south,
/obj/structure/table/reinforced,
/obj/machinery/newscaster/directional/south,
/turf/open/floor/mineral/titanium/tiled,
/area/shuttle/escape)
"AB" = (
/obj/structure/railing{
	dir = 4
	},
/obj/structure/chair/sofa/bench{
	dir = 8
	},
/turf/open/floor/mineral/titanium/tiled,
/area/shuttle/escape)
"AJ" = (
/obj/structure/chair/comfy/shuttle{
	dir = 8
	},
/turf/open/floor/mineral/titanium/tiled,
/area/shuttle/escape)
"Bl" = (
/obj/structure/chair/office{
	dir = 8
	},
/turf/open/floor/iron/dark/herringbone,
/area/shuttle/escape)
"BF" = (
/obj/machinery/door/airlock/medical{
	name = "Shuttle Infirmary"
	},
/turf/open/floor/mineral/titanium/tiled/blue,
/area/shuttle/escape)
"BL" = (
/obj/effect/turf_decal/siding/thinplating{
	dir = 10
	},
/turf/open/floor/mineral/titanium/white,
/area/shuttle/escape)
"BQ" = (
/obj/effect/turf_decal/siding/thinplating{
	dir = 5
	},
/turf/open/floor/mineral/titanium/white,
/area/shuttle/escape)
"Cg" = (
/obj/structure/railing{
	dir = 8
	},
/obj/structure/chair/sofa/bench/right{
	dir = 4
	},
/turf/open/floor/mineral/titanium/tiled,
/area/shuttle/escape)
"Cv" = (
/obj/effect/turf_decal/siding/thinplating_new{
	dir = 1
	},
/turf/open/floor/mineral/titanium/tiled,
/area/shuttle/escape)
"CL" = (
/obj/structure/table/reinforced,
/obj/effect/spawner/surgery_tray/full,
/obj/machinery/defibrillator_mount/directional/east,
/turf/open/floor/mineral/titanium/blue,
/area/shuttle/escape)
"CY" = (
/obj/effect/turf_decal/trimline/red/warning{
	dir = 1
	},
/turf/open/floor/mineral/titanium/white,
/area/shuttle/escape)
"Dw" = (
/obj/machinery/power/shuttle_engine/propulsion/left,
/turf/open/floor/plating/airless,
/area/shuttle/escape)
"DE" = (
/obj/effect/turf_decal/trimline/dark_blue/corner{
	dir = 4
	},
/obj/effect/turf_decal/trimline/yellow/line{
	dir = 8
	},
/obj/machinery/status_display/evac/directional/north,
/turf/open/floor/mineral/titanium/white,
/area/shuttle/escape)
"DM" = (
/obj/structure/railing/corner,
/turf/open/floor/mineral/titanium/tiled,
/area/shuttle/escape)
"Eb" = (
/obj/machinery/door/airlock/shuttle/glass{
	name = "Emergency Shuttle Airlock"
	},
/turf/open/floor/mineral/titanium/tiled/yellow,
/area/shuttle/escape)
"Ez" = (
/obj/structure/railing{
	dir = 1
	},
/obj/structure/chair/sofa/bench/right,
/turf/open/floor/mineral/titanium/tiled,
/area/shuttle/escape)
"EV" = (
/obj/structure/falsewall/titanium,
/turf/open/floor/grass,
/area/shuttle/escape)
"Fg" = (
/obj/structure/chair/comfy/shuttle{
	dir = 8
	},
/obj/structure/sign/poster/official/obey/directional/east,
/turf/open/floor/mineral/plastitanium/red,
/area/shuttle/escape/brig)
"FH" = (
/obj/effect/turf_decal/siding/thinplating/corner{
	dir = 8
	},
/obj/effect/turf_decal/trimline/yellow/line{
	dir = 4
	},
/turf/open/floor/mineral/titanium/white,
/area/shuttle/escape)
"FM" = (
/obj/machinery/computer/prisoner/management{
	dir = 4
	},
/turf/open/floor/iron/dark/herringbone,
/area/shuttle/escape)
"FN" = (
/obj/machinery/light/directional/south,
/turf/open/floor/mineral/titanium/white,
/area/shuttle/escape)
"GC" = (
/obj/machinery/door/airlock/medical/glass{
	name = "Shuttle Infirmary"
	},
/obj/effect/turf_decal/siding/blue{
	dir = 8
	},
/turf/open/floor/mineral/titanium/tiled/blue,
/area/shuttle/escape)
"GH" = (
/obj/structure/railing{
	dir = 10
	},
/obj/machinery/fishing_portal_generator,
/turf/open/floor/mineral/titanium/tiled,
/area/shuttle/escape)
"GR" = (
/obj/machinery/light/directional/north,
/turf/open/floor/mineral/titanium/white,
/area/shuttle/escape)
"GX" = (
/obj/effect/turf_decal/siding/thinplating/corner,
/turf/open/floor/mineral/titanium/white,
/area/shuttle/escape)
"Ht" = (
/obj/effect/turf_decal/trimline/yellow/corner,
/turf/open/floor/mineral/titanium/white,
/area/shuttle/escape)
"HU" = (
/obj/effect/turf_decal/siding/thinplating{
	dir = 8
	},
/obj/effect/turf_decal/siding/thinplating{
	dir = 8
	},
/obj/effect/turf_decal/trimline/blue/corner,
/turf/open/floor/mineral/titanium/white,
/area/shuttle/escape)
"HZ" = (
/obj/effect/turf_decal/siding/thinplating,
/obj/effect/turf_decal/siding/thinplating,
/obj/effect/turf_decal/trimline/yellow/line{
	dir = 1
	},
/turf/open/floor/mineral/titanium/white,
/area/shuttle/escape)
"Ie" = (
/obj/machinery/computer/communications,
/turf/open/floor/iron/dark/herringbone,
/area/shuttle/escape)
"Iq" = (
/obj/structure/railing,
/obj/structure/chair/sofa/bench{
	dir = 1
	},
/turf/open/floor/mineral/titanium/tiled,
/area/shuttle/escape)
"IC" = (
/obj/structure/table/reinforced,
/obj/item/assembly/flash,
/obj/machinery/cell_charger{
	pixel_y = 4
	},
/turf/open/floor/iron/dark/herringbone,
/area/shuttle/escape)
"IE" = (
/obj/machinery/status_display/evac/directional/south,
/turf/open/floor/iron/dark/herringbone,
/area/shuttle/escape)
"IT" = (
/obj/effect/turf_decal/delivery,
/obj/structure/closet/crate/internals,
/obj/item/tank/internals/emergency_oxygen{
	pixel_x = 3
	},
/obj/item/tank/internals/emergency_oxygen{
	pixel_x = 3
	},
/obj/item/tank/internals/emergency_oxygen{
	pixel_x = 3
	},
/obj/item/tank/internals/emergency_oxygen{
	pixel_x = 3
	},
/obj/item/clothing/mask/breath{
	pixel_x = -3;
	pixel_y = -3
	},
/obj/item/clothing/mask/breath{
	pixel_x = -3;
	pixel_y = -3
	},
/obj/item/clothing/mask/breath{
	pixel_x = -3;
	pixel_y = -3
	},
/obj/item/clothing/mask/breath{
	pixel_x = -3;
	pixel_y = -3
	},
/obj/effect/turf_decal/siding/thinplating_new{
	dir = 1
	},
/turf/open/floor/mineral/titanium,
/area/shuttle/escape)
"Je" = (
/obj/structure/chair/comfy/shuttle{
	dir = 4
	},
/turf/open/floor/mineral/plastitanium/red,
/area/shuttle/escape/brig)
"Jz" = (
/obj/structure/table/wood,
/obj/effect/turf_decal/siding/wood{
	dir = 4
	},
/obj/structure/window/reinforced/spawner/directional/east,
/turf/open/floor/wood,
/area/shuttle/escape)
"Kp" = (
/obj/machinery/recharge_station,
/turf/open/floor/mineral/titanium/yellow,
/area/shuttle/escape)
"KV" = (
/obj/structure/sign/poster/official/moth_meth/directional/east,
/obj/structure/table/reinforced,
/obj/item/storage/medkit/toxin,
/turf/open/floor/mineral/titanium/blue,
/area/shuttle/escape)
"Lx" = (
/obj/structure/railing{
	dir = 1
	},
/obj/structure/chair/sofa/bench/left,
/turf/open/floor/mineral/titanium/tiled,
/area/shuttle/escape)
"LU" = (
/obj/machinery/computer/station_alert,
/turf/open/floor/iron/dark/herringbone,
/area/shuttle/escape)
"MJ" = (
/obj/structure/flora/bush/sparsegrass/style_3,
/turf/open/floor/grass,
/area/shuttle/escape)
"NG" = (
/obj/structure/flora/bush/lavendergrass/style_3,
/obj/structure/flora/bush/sparsegrass/style_3,
/turf/open/floor/grass,
/area/shuttle/escape)
"NL" = (
/obj/structure/chair/office{
	dir = 4
	},
/turf/open/floor/iron/dark/herringbone,
/area/shuttle/escape)
"NT" = (
/obj/effect/turf_decal/siding/thinplating/corner,
/obj/effect/turf_decal/trimline/yellow/corner{
	dir = 4
	},
/turf/open/floor/mineral/titanium/white,
/area/shuttle/escape)
"OC" = (
/obj/effect/turf_decal/siding/thinplating{
	dir = 8
	},
/obj/effect/turf_decal/trimline/yellow/corner{
	dir = 4
	},
/turf/open/floor/mineral/titanium/white,
/area/shuttle/escape)
"OJ" = (
/turf/open/floor/wood,
/area/shuttle/escape)
"Pw" = (
/obj/structure/railing,
/obj/structure/chair/sofa/bench/right{
	dir = 1
	},
/turf/open/floor/mineral/titanium/tiled,
/area/shuttle/escape)
"Qn" = (
/obj/machinery/power/shuttle_engine/propulsion/right,
/turf/open/floor/plating/airless,
/area/shuttle/escape)
"QF" = (
/obj/structure/flora/bush/fullgrass/style_random,
/turf/open/floor/grass,
/area/shuttle/escape)
"Ri" = (
/obj/structure/railing{
	dir = 1
	},
/obj/structure/chair/sofa/bench,
/turf/open/floor/mineral/titanium/tiled,
/area/shuttle/escape)
"RK" = (
/turf/open/floor/mineral/titanium/tiled,
/area/shuttle/escape)
"RR" = (
/obj/machinery/light/directional/north,
/obj/structure/chair/comfy/shuttle,
/turf/open/floor/mineral/titanium/white,
/area/shuttle/escape)
"RS" = (
/obj/effect/turf_decal/trimline/red/corner{
	dir = 1
	},
/obj/effect/turf_decal/trimline/yellow/line{
	dir = 4
	},
/obj/machinery/newscaster/directional/north,
/turf/open/floor/mineral/titanium/white,
/area/shuttle/escape)
"RZ" = (
/obj/machinery/computer/crew{
	dir = 8
	},
/turf/open/floor/iron/dark/herringbone,
/area/shuttle/escape)
"SF" = (
/obj/structure/railing{
	dir = 4
	},
/obj/structure/lattice/catwalk,
/obj/structure/sign/poster/contraband/gorlex_recruitment/directional/north,
/obj/structure/chair/comfy/brown{
	buildstackamount = 0;
	color = "#DE3A3A";
	name = "Syndicated Chair";
	desc = "A 'Stowaway Premium' (TM) tactically padded red chair. A sticker on its backside reads 'Sponsored by Donk Co. in collaboration with Gorlex Securities.'"
	},
/obj/item/toy/plush/whiny_plushie,
/obj/item/newspaper{
	pixel_y = -6
	},
/turf/open/floor/catwalk_floor/airless,
/area/shuttle/escape)
"SU" = (
/obj/machinery/light/directional/south,
/obj/structure/table/reinforced,
/obj/machinery/vending/wallmed/directional/south,
/turf/open/floor/mineral/titanium/tiled,
/area/shuttle/escape)
"SX" = (
/obj/machinery/light/directional/west,
/obj/structure/chair/comfy/shuttle{
	dir = 4
	},
/turf/open/floor/mineral/plastitanium/red,
/area/shuttle/escape/brig)
"Te" = (
/turf/open/floor/mineral/titanium/tiled/blue,
/area/shuttle/escape)
"Tq" = (
/obj/machinery/door/airlock/command/glass{
	name = "Shuttle Flight Deck"
	},
/obj/effect/mapping_helpers/airlock/access/all/command/general,
/obj/effect/mapping_helpers/airlock/cyclelink_helper_multi{
	cycle_id = "shuttle-flight-deck"
	},
/obj/effect/turf_decal/siding/wood{
	dir = 1
	},
/turf/open/floor/wood,
/area/shuttle/escape)
"TG" = (
/obj/effect/turf_decal/siding/thinplating/corner{
	dir = 4
	},
/turf/open/floor/mineral/titanium/white,
/area/shuttle/escape)
"TK" = (
/turf/open/floor/mineral/titanium/blue,
/area/shuttle/escape)
"Uc" = (
/obj/machinery/iv_drip,
/obj/item/reagent_containers/blood/o_minus,
/obj/item/reagent_containers/blood/lizard,
/obj/item/reagent_containers/blood/ethereal,
/turf/open/floor/mineral/titanium/blue,
/area/shuttle/escape)
"UD" = (
/turf/open/floor/mineral/titanium/tiled/yellow,
/area/shuttle/escape)
"Vd" = (
/obj/machinery/door/airlock/security/glass{
	name = "Shuttle Brig"
	},
/obj/effect/mapping_helpers/airlock/access/all/security/general,
/turf/open/floor/mineral/plastitanium,
/area/shuttle/escape/brig)
"VB" = (
/obj/item/storage/medkit/regular,
/obj/structure/table/reinforced,
/obj/machinery/light/directional/north,
/turf/open/floor/iron/dark/herringbone,
/area/shuttle/escape)
"VM" = (
/obj/structure/chair/comfy/shuttle{
	dir = 8
	},
/turf/open/floor/mineral/titanium/yellow,
/area/shuttle/escape)
"VY" = (
/obj/structure/railing{
	dir = 4
	},
/obj/structure/chair/sofa/bench/left{
	dir = 8
	},
/turf/open/floor/mineral/titanium/tiled,
/area/shuttle/escape)
"Wh" = (
/obj/machinery/power/shuttle_engine/propulsion,
/turf/open/floor/plating/airless,
/area/shuttle/escape)
"WW" = (
/obj/structure/railing{
	dir = 8
	},
/obj/structure/chair/sofa/bench/left{
	dir = 4
	},
/turf/open/floor/mineral/titanium/tiled,
/area/shuttle/escape)
"Xm" = (
/obj/structure/railing{
	dir = 1
	},
/obj/structure/chair/comfy/shuttle{
	dir = 8
	},
/turf/open/floor/mineral/titanium/yellow,
/area/shuttle/escape)
"Xo" = (
/turf/open/floor/mineral/titanium/yellow,
/area/shuttle/escape)
"XW" = (
/obj/item/storage/toolbox/emergency,
/obj/structure/table/reinforced,
/obj/item/storage/toolbox/mechanical{
	pixel_y = 5
	},
/turf/open/floor/iron/dark/herringbone,
/area/shuttle/escape)
"Yl" = (
/obj/effect/turf_decal/stripes/line,
/obj/structure/sign/poster/official/moth_hardhat/directional/north,
/turf/open/floor/iron/recharge_floor,
/area/shuttle/escape)
"Yq" = (
/obj/effect/turf_decal/siding/thinplating{
	dir = 9
	},
/turf/open/floor/mineral/titanium/white,
/area/shuttle/escape)
"Yx" = (
/obj/structure/chair/comfy/shuttle{
	dir = 4
	},
/obj/effect/turf_decal/siding/thinplating_new{
	dir = 1
	},
/turf/open/floor/mineral/titanium/tiled,
/area/shuttle/escape)
"Zp" = (
/obj/structure/railing{
	dir = 9
	},
/obj/structure/table/reinforced,
/obj/item/storage/toolbox/fishing,
/turf/open/floor/mineral/titanium/tiled,
/area/shuttle/escape)
"Zt" = (
/obj/structure/table/reinforced,
/obj/effect/turf_decal/siding/thinplating_new{
	dir = 1
	},
/turf/open/floor/mineral/titanium/tiled,
/area/shuttle/escape)
"ZH" = (
/obj/structure/table/reinforced,
/obj/structure/reagent_dispensers/wall/peppertank/directional/north,
/obj/item/reagent_containers/spray/pepper{
	pixel_x = -7
	},
/obj/item/assembly/flash,
/obj/item/toy/plush/batong,
/turf/open/floor/mineral/plastitanium/red,
/area/shuttle/escape/brig)

(1,1,1) = {"
ls
ls
ls
ls
ls
ls
ls
ef
ng
ef
kM
ef
dk
dk
dk
ef
ng
ef
ng
uy
oN
bt
ls
ls
"}
(2,1,1) = {"
ls
ls
ls
ef
ef
dk
ef
ef
cf
cf
cf
ef
tU
ie
gp
ef
cf
cf
cf
uy
uy
bt
bt
ls
"}
(3,1,1) = {"
ls
ls
ef
uy
ZH
Je
SX
ef
cf
zB
FN
ef
OJ
OJ
OJ
ef
GR
zB
cf
IT
dk
qa
Wh
ls
"}
(4,1,1) = {"
ls
ls
ef
at
yi
yi
yi
ef
sf
zB
cf
Ai
OJ
OJ
OJ
gT
cf
zB
cf
Yx
dk
qa
Wh
ls
"}
(5,1,1) = {"
ls
ls
dk
ys
yi
yi
yi
dk
CY
zB
cf
sy
iv
Jz
dQ
jr
cf
zB
cf
kE
ef
oN
bt
ls
"}
(6,1,1) = {"
ls
ls
dk
ys
yi
yi
yi
dk
CY
cf
cf
gh
hl
zg
zg
ts
cf
cf
cf
oz
uy
uy
bt
bt
"}
(7,1,1) = {"
ls
ls
dk
ys
yi
yi
yi
Vd
CY
fp
GX
td
td
td
td
td
TG
xH
cf
Cv
RK
dk
cc
Dw
"}
(8,1,1) = {"
ls
ls
ef
gJ
yi
Fg
ll
ef
RS
NT
bo
DM
xW
AB
VY
ej
BQ
TG
cf
Yx
gc
dk
cc
Qn
"}
(9,1,1) = {"
ls
ef
ef
ef
kJ
uy
ef
ef
pB
oA
DM
hW
ov
sG
ov
wR
ej
vD
cf
Zt
Al
ef
oN
oN
"}
(10,1,1) = {"
ef
uy
FM
kt
az
ef
ls
ef
RR
oA
yl
ov
gr
ov
QF
MJ
Ez
vD
cf
oz
AJ
dk
qa
Dw
"}
(11,1,1) = {"
ef
yv
Bl
Bl
az
dk
ls
dk
eC
HZ
Iq
ov
ov
yC
NG
ov
Ri
vD
cf
Cv
RK
dk
qa
Wh
"}
(12,1,1) = {"
dk
dF
az
az
az
dk
ls
dk
eC
oA
Pw
ov
sG
QF
QF
ov
Lx
vD
cf
Yx
gc
dk
qa
Qn
"}
(13,1,1) = {"
dk
Ie
iS
az
IE
uy
ef
uy
DE
aZ
vL
GH
ov
aW
ov
Zp
eo
vD
cf
Zt
SU
ef
oN
oN
"}
(14,1,1) = {"
dk
rs
iS
az
az
Tq
OJ
tu
qo
lJ
BL
vL
WW
od
Cg
eo
Yq
lu
cf
oz
AJ
dk
cc
Dw
"}
(15,1,1) = {"
dk
LU
iS
az
az
Tq
bB
tu
qo
Ht
FH
uq
OC
fO
uk
HU
hE
fj
zr
IT
zf
dk
cc
Qn
"}
(16,1,1) = {"
dk
IC
az
az
az
ef
EV
ef
ef
ef
Eb
Eb
ef
ef
ef
dk
GC
GC
dk
ef
ef
uy
bt
bt
"}
(17,1,1) = {"
ef
VB
NL
NL
gH
ef
gv
ef
jv
Xo
Xo
Xo
Kp
ef
uT
Uc
TK
TK
TK
kd
ef
oN
bt
ls
"}
(18,1,1) = {"
ef
uy
RZ
al
XW
ef
qM
ef
Yl
Xo
UD
UD
Xo
BF
TK
Te
Te
Te
Te
tC
dk
qa
Wh
ls
"}
(19,1,1) = {"
ls
ef
ef
dk
ef
ef
vg
ef
cu
Xo
UD
UD
Xo
BF
TK
Te
Te
Te
cM
CL
dk
qa
Wh
ls
"}
(20,1,1) = {"
ls
ls
ls
ls
ls
ef
ef
ef
xo
Xm
VM
VM
pu
ef
wB
wp
wp
tp
KV
uy
uy
oN
oN
ls
"}
(21,1,1) = {"
ls
ls
ls
ls
ls
ls
ls
ef
ef
dk
dk
dk
ef
ef
ef
dk
dk
dk
ef
uy
oN
oN
SF
ls
"}
