//MAP CONVERTED BY dmm2tgm.py THIS HEADER COMMENT PREVENTS RECONVERSION, DO NOT REMOVE
"a" = (
/turf/template_noop,
/area/template_noop)
"b" = (
/obj/machinery/door/poddoor/shutters{
	name = "Escape Shuttle Cargo Shutters"
	},
/turf/open/floor/mineral/titanium/white,
/area/shuttle/escape)
"c" = (
/obj/machinery/status_display/evac/directional/south,
/turf/open/floor/mineral/titanium/white,
/area/shuttle/escape)
"d" = (
/obj/structure/chair{
	dir = 8
	},
/turf/open/floor/iron,
/area/shuttle/escape/brig)
"e" = (
/obj/machinery/computer/communications,
/turf/open/floor/mineral/titanium/white,
/area/shuttle/escape)
"f" = (
/obj/structure/reagent_dispensers/watertank,
/turf/open/floor/mineral/titanium/white,
/area/shuttle/escape)
"g" = (
/obj/structure/bed/dogbed,
/obj/machinery/status_display/evac/directional/north,
/turf/open/floor/mineral/titanium/white,
/area/shuttle/escape)
"i" = (
/obj/structure/shuttle/engine/heater{
	dir = 4
	},
/obj/structure/window/reinforced{
	dir = 8
	},
/turf/open/floor/plating,
/area/shuttle/escape)
"k" = (
/turf/open/floor/iron,
/area/shuttle/escape/brig)
"m" = (
/obj/structure/table,
/obj/machinery/recharger{
	active_power_usage = 0;
	idle_power_usage = 0;
	use_power = 0
	},
/obj/item/assembly/flash/handheld,
/obj/item/restraints/handcuffs,
/obj/machinery/status_display/evac/directional/south,
/turf/open/floor/mineral/titanium/white,
/area/shuttle/escape/brig)
"n" = (
/turf/open/floor/mineral/titanium/white,
/area/shuttle/escape)
"p" = (
/obj/machinery/space_heater,
/turf/open/floor/mineral/titanium/white,
/area/shuttle/escape)
"s" = (
/obj/machinery/portable_atmospherics/canister/oxygen,
/turf/open/floor/mineral/titanium/white,
/area/shuttle/escape)
"t" = (
/obj/structure/chair/office{
	dir = 8
	},
/turf/open/floor/mineral/titanium/white,
/area/shuttle/escape)
"u" = (
/obj/machinery/door/poddoor/shutters{
	id = "shuttlecargo";
	name = "Escape Shuttle Cargo Shutters"
	},
/turf/open/floor/mineral/titanium/white,
/area/shuttle/escape)
"v" = (
/obj/structure/rack,
/obj/item/storage/medkit/regular,
/turf/open/floor/mineral/titanium/white,
/area/shuttle/escape)
"w" = (
/obj/machinery/status_display/evac/directional/north,
/turf/open/floor/mineral/titanium/white,
/area/shuttle/escape)
"x" = (
/obj/structure/chair{
	dir = 4
	},
/obj/structure/window/reinforced{
	dir = 8
	},
/turf/open/floor/mineral/titanium/white,
/area/shuttle/escape)
"y" = (
/obj/structure/shuttle/engine/propulsion{
	dir = 8
	},
/turf/open/floor/plating,
/area/shuttle/escape)
"z" = (
/obj/structure/bed,
/obj/item/bedsheet/medical,
/turf/open/floor/mineral/titanium/white,
/area/shuttle/escape)
"A" = (
/obj/structure/chair{
	dir = 4
	},
/turf/open/floor/mineral/titanium/white,
/area/shuttle/escape)
"B" = (
/turf/closed/wall/mineral/titanium,
/area/shuttle/escape)
"C" = (
/obj/structure/table,
/obj/item/storage/medkit/fire,
/obj/item/storage/medkit/regular{
	pixel_x = 2;
	pixel_y = 3
	},
/turf/open/floor/mineral/titanium/white,
/area/shuttle/escape)
"D" = (
/obj/machinery/sleeper{
	dir = 4;
	icon_state = "sleeper-open"
	},
/turf/open/floor/mineral/titanium/white,
/area/shuttle/escape)
"E" = (
/obj/structure/reagent_dispensers/wall/peppertank{
	pixel_x = -29
	},
/obj/structure/closet/bombcloset,
/obj/machinery/status_display/evac/directional/north,
/turf/open/floor/iron,
/area/shuttle/escape/brig)
"F" = (
/obj/structure/sign/departments/medbay/alt{
	pixel_x = -32
	},
/obj/effect/spawner/structure/window/reinforced/shuttle,
/turf/open/floor/plating,
/area/shuttle/escape)
"G" = (
/obj/machinery/button/door{
	id = "shuttlecargo";
	name = "Cargo Shutters";
	pixel_y = -26
	},
/turf/open/floor/mineral/titanium/white,
/area/shuttle/escape)
"H" = (
/obj/structure/chair{
	dir = 8
	},
/turf/open/floor/mineral/titanium/white,
/area/shuttle/escape)
"I" = (
/obj/machinery/door/airlock/shuttle{
	name = "Emergency Shuttle Airlock"
	},
/turf/open/floor/mineral/titanium/white,
/area/shuttle/escape)
"J" = (
/obj/machinery/door/airlock/command/glass{
	name = "Cockpit";
	req_access_txt = "19"
	},
/turf/open/floor/mineral/titanium/white,
/area/shuttle/escape)
"K" = (
/obj/structure/table,
/obj/item/defibrillator/loaded,
/obj/machinery/status_display/evac/directional/south,
/turf/open/floor/mineral/titanium/white,
/area/shuttle/escape)
"L" = (
/obj/structure/chair{
	dir = 4
	},
/turf/open/floor/iron,
/area/shuttle/escape/brig)
"M" = (
/obj/structure/rack,
/obj/item/storage/toolbox/emergency{
	pixel_y = 3
	},
/turf/open/floor/mineral/titanium/white,
/area/shuttle/escape)
"N" = (
/obj/structure/sign/departments/medbay/alt{
	pixel_x = 32
	},
/obj/effect/spawner/structure/window/reinforced/shuttle,
/turf/open/floor/plating,
/area/shuttle/escape)
"O" = (
/mob/living/simple_animal/bot/medbot{
	name = "\improper emergency medibot";
	pixel_x = -3;
	pixel_y = 2
	},
/turf/open/floor/mineral/titanium/white,
/area/shuttle/escape)
"P" = (
/obj/machinery/button/door{
	id = "shuttlecargo";
	name = "Cargo Shutters";
	pixel_y = 26;
	req_access_txt = "50"
	},
/turf/open/floor/mineral/titanium/white,
/area/shuttle/escape)
"Q" = (
/obj/structure/table,
/obj/item/storage/medkit/toxin,
/obj/item/storage/medkit/o2{
	pixel_x = 3;
	pixel_y = 3
	},
/turf/open/floor/mineral/titanium/white,
/area/shuttle/escape)
"R" = (
/obj/machinery/door/airlock/shuttle{
	name = "Emergency Shuttle Airlock"
	},
/obj/docking_port/mobile/emergency{
	dir = 8;
	dwidth = 8;
	height = 19;
	name = "Disc emergency shuttle";
	width = 16
	},
/turf/open/floor/mineral/titanium/white,
/area/shuttle/escape)
"S" = (
/obj/structure/table,
/obj/item/scalpel{
	pixel_y = 12
	},
/obj/item/circular_saw,
/obj/item/retractor{
	pixel_x = 4
	},
/obj/item/hemostat{
	pixel_x = -4
	},
/obj/item/clothing/gloves/color/latex,
/obj/item/clothing/mask/surgical,
/obj/item/radio/intercom/directional/south,
/turf/open/floor/mineral/titanium/white,
/area/shuttle/escape)
"T" = (
/obj/machinery/computer/crew,
/turf/open/floor/mineral/titanium/white,
/area/shuttle/escape)
"U" = (
/turf/open/floor/circuit,
/area/shuttle/escape)
"V" = (
/obj/machinery/computer/emergency_shuttle,
/turf/open/floor/mineral/titanium/white,
/area/shuttle/escape)
"W" = (
/obj/effect/spawner/structure/window/reinforced/shuttle,
/turf/open/floor/plating,
/area/shuttle/escape)
"X" = (
/obj/machinery/door/airlock/medical/glass{
	name = "Escape Shuttle Infirmary"
	},
/turf/open/floor/mineral/titanium/white,
/area/shuttle/escape)
"Y" = (
/obj/machinery/door/airlock/security/glass{
	name = "Brig"
	},
/turf/open/floor/mineral/titanium/white,
/area/shuttle/escape)
"Z" = (
/obj/machinery/recharge_station,
/obj/machinery/status_display/evac/directional/north,
/turf/open/floor/circuit,
/area/shuttle/escape)

(1,1,1) = {"
a
a
B
W
W
W
B
a
a
B
W
W
W
B
a
a
"}
(2,1,1) = {"
a
a
B
U
U
U
B
a
a
B
e
T
V
B
a
a
"}
(3,1,1) = {"
a
a
B
n
n
n
B
B
B
B
v
t
M
B
a
a
"}
(4,1,1) = {"
a
a
B
w
n
n
n
n
A
B
g
n
c
B
a
a
"}
(5,1,1) = {"
a
a
W
H
H
H
H
n
n
J
n
n
n
W
a
a
"}
(6,1,1) = {"
a
a
W
x
x
x
x
n
n
B
t
t
t
W
a
a
"}
(7,1,1) = {"
a
a
B
n
n
n
n
n
n
B
B
B
B
B
a
a
"}
(8,1,1) = {"
a
B
B
H
H
H
H
n
n
F
A
D
C
B
B
a
"}
(9,1,1) = {"
a
W
x
x
x
x
x
n
n
X
n
n
z
Q
W
a
"}
(10,1,1) = {"
a
B
w
n
n
n
n
n
n
X
n
n
n
K
B
a
"}
(11,1,1) = {"
a
B
H
H
H
H
H
n
n
N
H
H
H
S
B
a
"}
(12,1,1) = {"
B
B
B
B
B
B
B
n
n
B
B
B
B
B
B
B
"}
(13,1,1) = {"
B
Z
s
p
f
O
B
n
n
B
E
L
L
L
m
B
"}
(14,1,1) = {"
W
n
n
n
n
n
b
n
n
Y
k
k
k
k
k
W
"}
(15,1,1) = {"
W
n
n
n
n
n
u
n
n
Y
k
k
k
k
k
W
"}
(16,1,1) = {"
B
H
H
H
H
G
B
P
n
B
k
d
d
d
d
B
"}
(17,1,1) = {"
B
B
B
B
B
I
B
n
n
B
I
B
B
B
B
B
"}
(18,1,1) = {"
i
i
i
i
B
n
W
n
n
W
n
B
i
i
i
i
"}
(19,1,1) = {"
y
y
y
y
B
I
B
R
I
B
I
B
y
y
y
y
"}
