//MAP CONVERTED BY dmm2tgm.py THIS HEADER COMMENT PREVENTS RECONVERSION, DO NOT REMOVE
"a" = (
/turf/open/space/basic,
/area/space)
"c" = (
/obj/effect/turf_decal/trimline/red/arrow_ccw,
/obj/effect/turf_decal/trimline/red/arrow_cw{
	dir = 1
	},
/turf/open/floor/pod/dark,
/area/space)
"d" = (
/obj/structure/railing{
	dir = 1
	},
/obj/machinery/computer/shuttle/ferry/request,
/obj/machinery/light/red/directional/north,
/turf/open/floor/pod/dark,
/area/space)
"e" = (
/obj/machinery/door/airlock/external/ruin,
/obj/effect/turf_decal/stripes/red/end{
	dir = 1
	},
/turf/closed/wall/mineral/plastitanium,
/area/space)
"k" = (
/obj/structure/chair/comfy/shuttle,
/obj/structure/railing{
	dir = 1
	},
/obj/machinery/light/red/directional/north,
/turf/open/floor/pod/dark,
/area/space)
"m" = (
/turf/closed/wall/mineral/plastitanium,
/area/space)
"n" = (
/obj/effect/turf_decal/trimline/red/arrow_cw{
	dir = 1
	},
/obj/effect/turf_decal/trimline/red/arrow_ccw,
/obj/effect/turf_decal/stripes/red/line{
	dir = 8
	},
/obj/structure/closet/crate,
/turf/open/floor/pod/dark,
/area/space)
"q" = (
/obj/structure/chair/comfy/shuttle{
	dir = 1
	},
/obj/structure/railing,
/obj/machinery/light/red/directional/south,
/turf/open/floor/pod/dark,
/area/space)
"r" = (
/obj/structure/shuttle/engine/propulsion/left{
	dir = 8
	},
/turf/open/floor/plating/airless,
/area/space)
"s" = (
/obj/structure/shuttle/engine/heater{
	dir = 8
	},
/obj/structure/window/reinforced{
	dir = 4
	},
/turf/open/floor/plating/airless,
/area/space)
"v" = (
/obj/docking_port/mobile{
	dir = 8;
	dwidth = 2;
	height = 13;
	id = "ferry";
	name = "ferry shuttle";
	preferred_direction = 4;
	width = 5
	},
/obj/machinery/door/airlock/titanium,
/turf/closed/wall/mineral/plastitanium,
/area/space)
"x" = (
/obj/effect/turf_decal/stripes/red/line{
	dir = 8
	},
/obj/structure/window/reinforced{
	dir = 1
	},
/obj/structure/tank_dispenser,
/turf/open/floor/pod/dark,
/area/space)
"z" = (
/obj/structure/shuttle/engine/heater{
	dir = 8
	},
/obj/structure/window/reinforced{
	dir = 4
	},
/obj/structure/window/reinforced,
/turf/open/floor/plating/airless,
/area/space)
"E" = (
/obj/structure/closet/crate,
/obj/effect/turf_decal/stripes/red/line{
	dir = 8
	},
/obj/structure/window/reinforced,
/turf/open/floor/pod/dark,
/area/space)
"F" = (
/obj/effect/turf_decal/stripes/red/line,
/turf/open/floor/pod/dark,
/area/space)
"G" = (
/obj/structure/shuttle/engine/heater{
	dir = 8
	},
/obj/structure/window/reinforced{
	dir = 4
	},
/obj/structure/window/reinforced{
	dir = 1
	},
/turf/open/floor/plating/airless,
/area/space)
"K" = (
/obj/structure/chair/comfy/shuttle{
	dir = 1
	},
/obj/structure/railing,
/turf/open/floor/pod/dark,
/area/space)
"M" = (
/obj/structure/chair/comfy/shuttle,
/obj/structure/railing{
	dir = 1
	},
/turf/open/floor/pod/dark,
/area/space)
"S" = (
/obj/machinery/door/airlock/external/ruin,
/obj/effect/turf_decal/stripes/red/end,
/turf/closed/wall/mineral/plastitanium,
/area/space)
"T" = (
/obj/effect/turf_decal/stripes/red/line{
	dir = 1
	},
/turf/open/floor/pod/dark,
/area/space)
"X" = (
/obj/structure/closet/crate,
/obj/structure/railing,
/obj/machinery/light/red/directional/south,
/turf/open/floor/pod/dark,
/area/space)

(1,1,1) = {"
a
r
r
r
a
"}
(2,1,1) = {"
r
s
s
s
r
"}
(3,1,1) = {"
z
x
n
E
G
"}
(4,1,1) = {"
m
k
c
q
m
"}
(5,1,1) = {"
m
M
c
K
m
"}
(6,1,1) = {"
m
M
c
K
m
"}
(7,1,1) = {"
m
M
c
K
m
"}
(8,1,1) = {"
m
k
c
q
m
"}
(9,1,1) = {"
e
T
c
F
S
"}
(10,1,1) = {"
m
M
c
K
m
"}
(11,1,1) = {"
m
M
c
K
m
"}
(12,1,1) = {"
m
d
c
X
m
"}
(13,1,1) = {"
m
m
v
m
m
"}
