//MAP CONVERTED BY dmm2tgm.py THIS HEADER COMMENT PREVENTS RECONVERSION, DO NOT REMOVE
"aa" = (
/turf/template_noop,
/area/template_noop)
"ab" = (
/obj/machinery/porta_turret/syndicate/shuttle{
	dir = 9
	},
/turf/closed/wall/r_wall/syndicate,
/area/shuttle/syndicate/bridge)
"ac" = (
/turf/closed/wall/r_wall/syndicate,
/area/shuttle/syndicate/bridge)
"ad" = (
/obj/machinery/porta_turret/syndicate/shuttle{
	dir = 10
	},
/turf/closed/wall/r_wall/syndicate,
/area/shuttle/syndicate/hallway)
"ae" = (
/obj/effect/spawner/structure/window/reinforced/plasma/plastitanium,
/obj/machinery/door/poddoor/shutters{
	id = "syndieshutters";
	name = "blast shutters"
	},
/turf/open/floor/plating,
/area/shuttle/syndicate/bridge)
"af" = (
/turf/closed/wall/r_wall/syndicate,
/area/shuttle/syndicate/hallway)
"ag" = (
/obj/item/clipboard,
/obj/item/folder/red,
/obj/structure/table/reinforced/plastitaniumglass,
/turf/open/floor/iron/dark/smooth_corner,
/area/shuttle/syndicate/bridge)
"ah" = (
/obj/item/storage/fancy/donut_box,
/obj/structure/table/reinforced/plastitaniumglass,
/turf/open/floor/iron/dark,
/area/shuttle/syndicate/bridge)
"ai" = (
/obj/machinery/computer/camera_advanced/shuttle_docker/syndicate,
/turf/open/floor/iron/dark,
/area/shuttle/syndicate/bridge)
"aj" = (
/obj/machinery/computer/shuttle/syndicate,
/turf/open/floor/iron/dark,
/area/shuttle/syndicate/bridge)
"ak" = (
/obj/machinery/computer/camera_advanced/syndie,
/turf/open/floor/iron/dark,
/area/shuttle/syndicate/bridge)
"al" = (
/obj/item/clothing/head/hos/syndicate,
/obj/item/stamp/syndicate{
	pixel_x = -7
	},
/obj/structure/table/reinforced/plastitaniumglass,
/turf/open/floor/iron/dark,
/area/shuttle/syndicate/bridge)
"am" = (
/obj/machinery/button/door{
	id = "syndieshutters";
	name = "Cockpit View Control";
	req_access_txt = "150";
	pixel_y = 24
	},
/obj/item/aicard,
/obj/structure/table/reinforced/plastitaniumglass,
/turf/open/floor/iron/dark/smooth_corner{
	dir = 8
	},
/area/shuttle/syndicate/bridge)
"an" = (
/obj/machinery/status_display/evac{
	pixel_x = -32
	},
/obj/machinery/light/directional/west,
/obj/machinery/computer/med_data/syndie{
	dir = 4
	},
/obj/effect/turf_decal/tile/red{
	dir = 8
	},
/turf/open/floor/iron/dark,
/area/shuttle/syndicate/bridge)
"ao" = (
/obj/structure/chair/office/tactical{
	dir = 8
	},
/turf/open/floor/catwalk_floor/iron_dark,
/area/shuttle/syndicate/bridge)
"ap" = (
/turf/open/floor/iron/dark,
/area/shuttle/syndicate/bridge)
"aq" = (
/obj/structure/chair/comfy/shuttle/tactical{
	dir = 1
	},
/turf/open/floor/iron/dark,
/area/shuttle/syndicate/bridge)
"ar" = (
/obj/structure/chair/office/tactical{
	dir = 4
	},
/turf/open/floor/catwalk_floor/iron_dark,
/area/shuttle/syndicate/bridge)
"as" = (
/obj/machinery/status_display/ai{
	pixel_x = 32
	},
/obj/machinery/light/directional/east,
/obj/effect/turf_decal/tile/red,
/obj/machinery/computer/aifixer{
	dir = 8
	},
/turf/open/floor/iron/dark,
/area/shuttle/syndicate/bridge)
"at" = (
/obj/machinery/computer/crew/syndie{
	dir = 4
	},
/obj/effect/turf_decal/tile/red/anticorner{
	dir = 8
	},
/turf/open/floor/iron/dark/smooth_corner{
	dir = 4
	},
/area/shuttle/syndicate/bridge)
"av" = (
/obj/machinery/door/airlock/hatch{
	req_access_txt = "150"
	},
/obj/effect/mapping_helpers/airlock/autoname,
/obj/effect/turf_decal/stripes/red/line{
	dir = 1
	},
/turf/open/floor/iron/dark,
/area/shuttle/syndicate/bridge)
"aw" = (
/obj/machinery/porta_turret/syndicate/shuttle{
	dir = 9
	},
/turf/closed/wall/r_wall/syndicate,
/area/shuttle/syndicate/eva)
"ax" = (
/turf/closed/wall/r_wall/syndicate,
/area/shuttle/syndicate/eva)
"ay" = (
/obj/effect/turf_decal/tile/red{
	dir = 1
	},
/turf/open/floor/iron/dark,
/area/shuttle/syndicate/hallway)
"az" = (
/obj/effect/spawner/structure/window/survival_pod,
/turf/open/floor/plating,
/area/shuttle/syndicate/hallway)
"aA" = (
/obj/effect/turf_decal/tile/red{
	dir = 4
	},
/turf/open/floor/iron/dark,
/area/shuttle/syndicate/hallway)
"aB" = (
/turf/closed/wall/r_wall/syndicate,
/area/shuttle/syndicate/airlock)
"aC" = (
/obj/structure/sign/poster/contraband/random/directional/west,
/turf/open/floor/iron/dark,
/area/shuttle/syndicate/hallway)
"aD" = (
/turf/open/floor/iron/dark,
/area/shuttle/syndicate/hallway)
"aF" = (
/obj/machinery/porta_turret/syndicate/shuttle{
	dir = 5
	},
/turf/closed/wall/r_wall/syndicate,
/area/shuttle/syndicate/engineering)
"aG" = (
/obj/machinery/porta_turret/syndicate/shuttle{
	dir = 9
	},
/turf/closed/wall/r_wall/syndicate,
/area/shuttle/syndicate/medical)
"aH" = (
/obj/machinery/light/directional/west,
/turf/open/floor/iron/dark/smooth_edge{
	dir = 8
	},
/area/shuttle/syndicate/hallway)
"aI" = (
/obj/machinery/light/directional/east,
/turf/open/floor/iron/dark/smooth_edge{
	dir = 4
	},
/area/shuttle/syndicate/hallway)
"aJ" = (
/turf/closed/wall/r_wall/syndicate,
/area/shuttle/syndicate/medical)
"aK" = (
/turf/closed/wall/r_wall/syndicate/nodiagonal,
/area/shuttle/syndicate/medical)
"aM" = (
/obj/machinery/status_display/evac/directional/south,
/obj/effect/turf_decal/siding/thinplating_new/dark{
	dir = 8
	},
/obj/effect/turf_decal/stripes/red/line{
	dir = 8
	},
/turf/open/floor/iron/dark/textured_corner{
	dir = 4
	},
/area/shuttle/syndicate/eva)
"aN" = (
/obj/structure/tank_dispenser/oxygen,
/turf/open/floor/iron/dark/smooth_corner{
	dir = 8
	},
/area/shuttle/syndicate/eva)
"aO" = (
/turf/open/floor/iron/dark/smooth_corner{
	dir = 4
	},
/area/shuttle/syndicate/airlock)
"aP" = (
/obj/machinery/status_display/ai/directional/south,
/obj/effect/turf_decal/siding/thinplating_new/dark{
	dir = 4
	},
/turf/open/floor/iron/dark/textured_corner{
	dir = 1
	},
/area/shuttle/syndicate/airlock)
"aQ" = (
/obj/structure/closet/syndicate/personal,
/obj/effect/turf_decal/bot_red,
/turf/open/floor/mineral/plastitanium,
/area/shuttle/syndicate/airlock)
"aR" = (
/obj/machinery/suit_storage_unit/syndicate,
/obj/effect/turf_decal/bot_red,
/obj/structure/sign/poster/contraband/random/directional/west,
/turf/open/floor/mineral/plastitanium,
/area/shuttle/syndicate/eva)
"aS" = (
/obj/structure/rack,
/obj/item/clothing/suit/space/syndicate,
/obj/item/clothing/head/helmet/space/syndicate,
/turf/open/floor/iron/dark/smooth_edge{
	dir = 4
	},
/area/shuttle/syndicate/eva)
"aT" = (
/obj/effect/turf_decal/loading_area/red{
	dir = 4
	},
/turf/open/floor/mineral/plastitanium,
/area/shuttle/syndicate/airlock)
"aU" = (
/obj/machinery/light/directional/east,
/obj/structure/rack,
/obj/item/crowbar/red,
/turf/open/floor/iron/dark/smooth_edge{
	dir = 4
	},
/area/shuttle/syndicate/eva)
"aV" = (
/obj/effect/spawner/structure/window/reinforced/plasma/plastitanium,
/turf/open/floor/plating,
/area/shuttle/syndicate/hallway)
"aW" = (
/obj/effect/mapping_helpers/airlock/autoname,
/obj/machinery/door/airlock/hatch{
	req_access_txt = "150"
	},
/obj/effect/turf_decal/stripes/red/line,
/turf/open/floor/iron/dark,
/area/shuttle/syndicate/hallway)
"aX" = (
/obj/machinery/light/directional/west,
/obj/item/sbeacondrop/bomb{
	pixel_y = 5
	},
/obj/item/sbeacondrop/bomb,
/obj/structure/table/reinforced/plastitaniumglass,
/turf/open/floor/iron/dark/smooth_edge{
	dir = 8
	},
/area/shuttle/syndicate/airlock)
"aY" = (
/obj/machinery/door/poddoor{
	id = "smindicate";
	name = "outer blast door"
	},
/obj/docking_port/mobile/infiltrator,
/obj/structure/fans/tiny,
/obj/machinery/button/door/directional/north{
	id = "smindicate";
	name = "external door control";
	req_access_txt = "150"
	},
/obj/effect/turf_decal/siding/thinplating_new/dark{
	dir = 8
	},
/turf/open/floor/plating,
/area/shuttle/syndicate/airlock)
"aZ" = (
/turf/open/floor/iron/dark,
/area/shuttle/syndicate/eva)
"bc" = (
/turf/open/floor/iron/dark,
/area/shuttle/syndicate/airlock)
"bd" = (
/obj/structure/sign/warning/vacuum/external,
/turf/closed/wall/r_wall/syndicate,
/area/shuttle/syndicate/airlock)
"be" = (
/obj/machinery/suit_storage_unit/syndicate,
/obj/effect/turf_decal/bot_red,
/turf/open/floor/mineral/plastitanium,
/area/shuttle/syndicate/eva)
"bf" = (
/obj/effect/turf_decal/syndicateemblem/top/left,
/obj/item/radio/intercom/directional/west,
/turf/open/floor/mineral/plastitanium/red,
/area/shuttle/syndicate/hallway)
"bg" = (
/obj/effect/spawner/structure/window/reinforced/plasma/plastitanium,
/turf/open/floor/plating,
/area/shuttle/syndicate/eva)
"bh" = (
/obj/effect/spawner/structure/window/reinforced/plasma/plastitanium,
/turf/open/floor/plating,
/area/shuttle/syndicate/airlock)
"bi" = (
/obj/structure/chair/comfy/shuttle/tactical{
	dir = 8
	},
/obj/effect/turf_decal/bot_red,
/turf/open/floor/mineral/plastitanium,
/area/shuttle/syndicate/airlock)
"bj" = (
/turf/closed/wall/r_wall/syndicate/nodiagonal,
/area/shuttle/syndicate/engineering)
"bm" = (
/turf/closed/wall/r_wall/syndicate,
/area/shuttle/syndicate/engineering)
"bo" = (
/obj/item/toy/plush/carpplushie{
	pixel_x = 6;
	pixel_y = 9
	},
/obj/item/toy/figure/syndie{
	pixel_y = -2;
	pixel_x = 11
	},
/turf/open/floor/fakespace,
/area/shuttle/syndicate/hallway)
"bq" = (
/obj/structure/table/reinforced,
/obj/item/reagent_containers/glass/beaker/large{
	pixel_x = 5;
	pixel_y = 5
	},
/obj/item/reagent_containers/glass/beaker,
/obj/item/reagent_containers/dropper{
	pixel_x = -4;
	pixel_y = -8
	},
/obj/effect/turf_decal/tile/yellow{
	dir = 1
	},
/turf/open/floor/iron,
/area/shuttle/syndicate/medical)
"br" = (
/turf/open/floor/catwalk_floor/iron_dark,
/area/shuttle/syndicate/medical)
"bs" = (
/obj/machinery/light/directional/north,
/obj/structure/bed/roller,
/obj/machinery/iv_drip,
/obj/effect/turf_decal/siding/thinplating_new{
	dir = 4
	},
/obj/structure/railing{
	dir = 4
	},
/turf/open/floor/iron/dark/textured_large,
/area/shuttle/syndicate/medical)
"bt" = (
/obj/item/reagent_containers/syringe/epinephrine{
	pixel_x = 3;
	pixel_y = -2
	},
/obj/item/reagent_containers/syringe/epinephrine{
	pixel_x = 4;
	pixel_y = 1
	},
/obj/item/reagent_containers/syringe/epinephrine{
	pixel_y = 5
	},
/obj/item/reagent_containers/syringe/epinephrine{
	pixel_x = 2;
	pixel_y = 8
	},
/obj/structure/table/reinforced,
/obj/machinery/status_display/ai/directional/north,
/obj/effect/turf_decal/tile/blue{
	dir = 1
	},
/turf/open/floor/iron/edge,
/area/shuttle/syndicate/medical)
"bu" = (
/obj/structure/table/reinforced,
/obj/item/stack/medical/gauze,
/obj/item/stack/medical/bruise_pack,
/obj/item/stack/medical/ointment,
/obj/effect/turf_decal/tile/blue{
	dir = 4
	},
/turf/open/floor/iron/edge,
/area/shuttle/syndicate/medical)
"bv" = (
/obj/effect/spawner/structure/window/reinforced/plasma/plastitanium,
/turf/open/floor/plating,
/area/shuttle/syndicate/medical)
"bw" = (
/obj/effect/spawner/structure/window/reinforced/plasma/plastitanium,
/turf/open/floor/plating,
/area/shuttle/syndicate/engineering)
"bx" = (
/obj/item/assembly/prox_sensor{
	pixel_x = -8;
	pixel_y = 4
	},
/obj/item/assembly/prox_sensor{
	pixel_x = -8;
	pixel_y = 4
	},
/obj/item/stack/cable_coil,
/obj/item/stack/cable_coil,
/obj/item/assembly/voice{
	pixel_y = 3
	},
/obj/structure/table/reinforced/plastitaniumglass,
/turf/open/floor/iron/dark/side,
/area/shuttle/syndicate/engineering)
"by" = (
/obj/machinery/status_display/evac/directional/north,
/obj/item/assembly/signaler{
	pixel_x = 8
	},
/obj/item/assembly/infra,
/obj/structure/table/reinforced/plastitaniumglass,
/turf/open/floor/iron/dark/side,
/area/shuttle/syndicate/engineering)
"bz" = (
/obj/machinery/light/directional/north,
/obj/item/weldingtool/largetank{
	pixel_y = 3
	},
/obj/item/multitool,
/obj/item/wrench,
/obj/item/crowbar/red,
/obj/structure/table/reinforced/plastitaniumglass,
/turf/open/floor/iron/dark/side,
/area/shuttle/syndicate/engineering)
"bA" = (
/obj/machinery/portable_atmospherics/canister/oxygen,
/obj/effect/turf_decal/stripes/line{
	dir = 10
	},
/obj/structure/railing{
	dir = 8
	},
/obj/structure/sign/poster/contraband/random/directional/north,
/turf/open/floor/plating,
/area/shuttle/syndicate/engineering)
"bB" = (
/obj/machinery/portable_atmospherics/canister/oxygen,
/obj/effect/turf_decal/stripes/line,
/turf/open/floor/plating,
/area/shuttle/syndicate/engineering)
"bC" = (
/obj/machinery/sleeper/syndie{
	dir = 4
	},
/obj/effect/turf_decal/siding/thinplating_new,
/obj/structure/railing,
/turf/open/floor/iron/dark/textured_large,
/area/shuttle/syndicate/medical)
"bD" = (
/obj/effect/turf_decal/siding/thinplating_new,
/turf/open/floor/catwalk_floor/iron_dark,
/area/shuttle/syndicate/medical)
"bE" = (
/obj/machinery/light/directional/west,
/obj/effect/turf_decal/syndicateemblem/bottom/left,
/obj/structure/sign/departments/medbay/alt{
	pixel_x = -32
	},
/turf/open/floor/mineral/plastitanium/red,
/area/shuttle/syndicate/hallway)
"bF" = (
/obj/machinery/light/directional/east,
/obj/effect/turf_decal/syndicateemblem/bottom/right,
/obj/structure/sign/departments/engineering{
	pixel_x = 32
	},
/turf/open/floor/mineral/plastitanium/red,
/area/shuttle/syndicate/hallway)
"bG" = (
/obj/effect/turf_decal/tile/yellow{
	dir = 1
	},
/turf/open/floor/iron/dark/textured,
/area/shuttle/syndicate/engineering)
"bH" = (
/turf/open/floor/iron/white/side,
/area/shuttle/syndicate/medical)
"bK" = (
/obj/effect/turf_decal/siding/thinplating_new/dark/corner,
/obj/effect/mapping_helpers/airlock/autoname,
/obj/machinery/door/airlock/hatch{
	req_access_txt = "150"
	},
/obj/effect/turf_decal/siding/thinplating_new{
	dir = 8
	},
/turf/open/floor/mineral/plastitanium/red,
/area/shuttle/syndicate/medical)
"bL" = (
/obj/effect/turf_decal/siding/thinplating_new/dark,
/turf/open/floor/mineral/plastitanium/red,
/area/shuttle/syndicate/hallway)
"bM" = (
/obj/effect/turf_decal/siding/thinplating_new/dark{
	dir = 4
	},
/obj/effect/turf_decal/siding/thinplating_new/dark/corner{
	dir = 8
	},
/obj/effect/mapping_helpers/airlock/autoname,
/obj/machinery/door/airlock/hatch{
	req_access_txt = "150"
	},
/turf/open/floor/mineral/plastitanium/red,
/area/shuttle/syndicate/engineering)
"bO" = (
/turf/open/floor/iron/dark/textured_corner,
/area/shuttle/syndicate/engineering)
"bP" = (
/obj/effect/turf_decal/siding/red,
/obj/structure/window/reinforced/survival_pod{
	dir = 1
	},
/obj/effect/turf_decal/stripes/red/line{
	dir = 1
	},
/turf/open/floor/iron/dark/smooth_edge,
/area/shuttle/syndicate/engineering)
"bR" = (
/obj/structure/table/reinforced,
/obj/item/reagent_containers/glass/bottle/epinephrine{
	pixel_x = -3;
	pixel_y = 8
	},
/obj/item/reagent_containers/glass/bottle/multiver{
	pixel_x = 6;
	pixel_y = 8
	},
/obj/item/reagent_containers/glass/bottle/multiver{
	pixel_x = -3
	},
/obj/item/reagent_containers/glass/bottle/epinephrine{
	pixel_x = 6
	},
/obj/effect/turf_decal/tile/yellow/half{
	dir = 8
	},
/turf/open/floor/iron/edge{
	dir = 8
	},
/area/shuttle/syndicate/medical)
"bS" = (
/obj/effect/turf_decal/tile/blue{
	dir = 1
	},
/turf/open/floor/iron/corner{
	dir = 1
	},
/area/shuttle/syndicate/medical)
"bU" = (
/turf/open/floor/iron/dark/smooth_corner,
/area/shuttle/syndicate/hallway)
"bV" = (
/obj/structure/chair/stool/directional/east,
/turf/open/floor/iron/dark,
/area/shuttle/syndicate/engineering)
"bW" = (
/turf/open/floor/iron/dark/textured_corner{
	dir = 1
	},
/area/shuttle/syndicate/engineering)
"bY" = (
/obj/structure/closet,
/obj/effect/turf_decal/tile/yellow{
	dir = 8
	},
/turf/open/floor/iron,
/area/shuttle/syndicate/medical)
"bZ" = (
/obj/effect/turf_decal/tile/blue/full,
/turf/open/floor/iron/large,
/area/shuttle/syndicate/medical)
"ca" = (
/turf/open/floor/iron,
/area/shuttle/syndicate/medical)
"cb" = (
/obj/item/storage/medkit/regular{
	pixel_x = 3;
	pixel_y = 3
	},
/obj/item/storage/medkit/brute,
/obj/item/storage/medkit/regular{
	pixel_x = -3;
	pixel_y = -3
	},
/obj/structure/table/reinforced,
/obj/effect/turf_decal/tile/blue,
/turf/open/floor/iron/corner,
/area/shuttle/syndicate/medical)
"cc" = (
/obj/item/storage/medkit/regular{
	pixel_x = 3;
	pixel_y = 3
	},
/obj/item/storage/medkit/fire,
/obj/item/storage/medkit/regular{
	pixel_x = -3;
	pixel_y = -3
	},
/obj/structure/table/reinforced,
/obj/effect/turf_decal/tile/blue,
/obj/structure/sign/poster/contraband/random/directional/south,
/turf/open/floor/iron/edge{
	dir = 1
	},
/area/shuttle/syndicate/medical)
"ce" = (
/obj/machinery/cell_charger,
/obj/item/stock_parts/cell/high{
	pixel_x = -3;
	pixel_y = 3
	},
/obj/item/stock_parts/cell/high,
/obj/effect/turf_decal/tile/yellow{
	dir = 8
	},
/obj/structure/extinguisher_cabinet/directional/west,
/obj/structure/table/reinforced/plastitaniumglass,
/turf/open/floor/iron/dark/textured,
/area/shuttle/syndicate/engineering)
"cf" = (
/obj/item/storage/toolbox/syndicate,
/obj/item/screwdriver{
	pixel_y = 9
	},
/obj/structure/table/reinforced/plastitaniumglass,
/turf/open/floor/iron/dark,
/area/shuttle/syndicate/engineering)
"cg" = (
/obj/structure/reagent_dispensers/fueltank,
/turf/open/floor/iron/dark,
/area/shuttle/syndicate/engineering)
"ch" = (
/turf/open/floor/iron/dark,
/area/shuttle/syndicate/engineering)
"ci" = (
/obj/effect/turf_decal/tile/yellow,
/turf/open/floor/iron/dark/textured,
/area/shuttle/syndicate/engineering)
"cj" = (
/obj/structure/table/reinforced,
/obj/machinery/light/directional/west,
/obj/item/bodypart/l_arm/robot{
	pixel_x = -4;
	pixel_y = 8
	},
/obj/item/bodypart/r_arm/robot{
	pixel_x = -10;
	pixel_y = 9
	},
/obj/item/surgicaldrill,
/obj/item/circular_saw,
/obj/effect/turf_decal/tile/blue{
	dir = 8
	},
/turf/open/floor/iron/white/side,
/area/shuttle/syndicate/medical)
"ck" = (
/obj/structure/sink{
	dir = 8;
	pixel_x = 11
	},
/obj/structure/mirror/directional/east,
/obj/effect/turf_decal/tile/blue,
/turf/open/floor/iron/white/side,
/area/shuttle/syndicate/medical)
"cl" = (
/turf/open/floor/fakespace,
/area/shuttle/syndicate/hallway)
"cn" = (
/obj/machinery/light/directional/east,
/obj/effect/turf_decal/siding/red,
/obj/structure/window/reinforced/survival_pod{
	dir = 1
	},
/obj/effect/turf_decal/stripes/red/line{
	dir = 1
	},
/turf/open/floor/iron/dark/smooth_edge,
/area/shuttle/syndicate/engineering)
"co" = (
/obj/item/cautery,
/obj/item/scalpel,
/obj/structure/table/reinforced,
/obj/effect/turf_decal/tile/blue{
	dir = 8
	},
/turf/open/floor/iron/white,
/area/shuttle/syndicate/medical)
"cp" = (
/obj/structure/table/optable,
/obj/item/surgical_drapes,
/turf/open/floor/iron/white,
/area/shuttle/syndicate/medical)
"cq" = (
/obj/item/retractor,
/obj/item/hemostat,
/obj/structure/table/reinforced,
/obj/effect/turf_decal/tile/blue,
/turf/open/floor/iron/white,
/area/shuttle/syndicate/medical)
"cr" = (
/obj/structure/shuttle/engine/heater,
/obj/effect/turf_decal/stripes/line,
/obj/structure/window/reinforced/survival_pod{
	dir = 1
	},
/turf/open/floor/plating/airless,
/area/shuttle/syndicate/hallway)
"cs" = (
/obj/machinery/recharge_station,
/turf/open/floor/circuit/red,
/area/shuttle/syndicate/engineering)
"ct" = (
/obj/machinery/telecomms/allinone{
	intercept = 1
	},
/turf/open/floor/circuit/red,
/area/shuttle/syndicate/engineering)
"cu" = (
/obj/structure/shuttle/engine/heater,
/obj/effect/turf_decal/stripes/line,
/obj/structure/window/reinforced/survival_pod{
	dir = 1
	},
/turf/open/floor/plating/airless,
/area/shuttle/syndicate/medical)
"cv" = (
/obj/structure/shuttle/engine/propulsion/left,
/obj/effect/turf_decal/stripes/line,
/turf/open/floor/plating/airless,
/area/shuttle/syndicate/hallway)
"cw" = (
/obj/structure/shuttle/engine/propulsion,
/obj/effect/turf_decal/stripes/line,
/turf/open/floor/plating/airless,
/area/shuttle/syndicate/hallway)
"cx" = (
/obj/structure/shuttle/engine/propulsion/right,
/obj/effect/turf_decal/stripes/line,
/turf/open/floor/plating/airless,
/area/shuttle/syndicate/hallway)
"cy" = (
/obj/structure/shuttle/engine/heater,
/obj/effect/turf_decal/stripes/line,
/obj/structure/window/reinforced/survival_pod{
	dir = 1
	},
/turf/open/floor/plating/airless,
/area/shuttle/syndicate/engineering)
"cz" = (
/obj/structure/shuttle/engine/propulsion/left,
/obj/effect/turf_decal/stripes/line,
/turf/open/floor/plating/airless,
/area/shuttle/syndicate/medical)
"cA" = (
/obj/structure/shuttle/engine/propulsion,
/obj/effect/turf_decal/stripes/line,
/turf/open/floor/plating/airless,
/area/shuttle/syndicate/medical)
"cB" = (
/obj/structure/shuttle/engine/propulsion/right,
/obj/effect/turf_decal/stripes/line,
/turf/open/floor/plating/airless,
/area/shuttle/syndicate/medical)
"cE" = (
/obj/structure/shuttle/engine/propulsion/left,
/obj/effect/turf_decal/stripes/line,
/turf/open/floor/plating/airless,
/area/shuttle/syndicate/engineering)
"cF" = (
/obj/structure/shuttle/engine/propulsion,
/obj/effect/turf_decal/stripes/line,
/turf/open/floor/plating/airless,
/area/shuttle/syndicate/engineering)
"cG" = (
/obj/structure/shuttle/engine/propulsion/right,
/obj/effect/turf_decal/stripes/line,
/turf/open/floor/plating/airless,
/area/shuttle/syndicate/engineering)
"dp" = (
/obj/machinery/porta_turret/syndicate/shuttle{
	dir = 10
	},
/turf/closed/wall/r_wall/syndicate,
/area/shuttle/syndicate/engineering)
"fI" = (
/obj/effect/turf_decal/siding/thinplating_new/dark{
	dir = 1
	},
/turf/open/floor/mineral/plastitanium/red,
/area/shuttle/syndicate/hallway)
"jk" = (
/turf/open/floor/iron/large,
/area/shuttle/syndicate/medical)
"jt" = (
/obj/machinery/door/window/survival_pod{
	dir = 1;
	req_access_txt = "150";
	name = "Telecommunications Centre"
	},
/obj/effect/turf_decal/siding/red,
/obj/effect/turf_decal/stripes/red/line{
	dir = 1
	},
/turf/open/floor/iron/dark/smooth_edge,
/area/shuttle/syndicate/engineering)
"kx" = (
/obj/effect/turf_decal/siding/thinplating_new/dark{
	dir = 8
	},
/obj/effect/turf_decal/stripes/red/line{
	dir = 8
	},
/turf/open/floor/iron/dark/textured_corner,
/area/shuttle/syndicate/eva)
"mZ" = (
/turf/open/floor/iron/dark/smooth_corner{
	dir = 8
	},
/area/shuttle/syndicate/hallway)
"nH" = (
/obj/item/grenade/syndieminibomb{
	pixel_x = 4;
	pixel_y = 2
	},
/obj/item/grenade/syndieminibomb{
	pixel_x = -1
	},
/obj/item/grenade/c4{
	pixel_x = -6
	},
/obj/item/grenade/c4{
	pixel_x = -6
	},
/obj/item/grenade/c4{
	pixel_x = -6
	},
/obj/item/grenade/c4{
	pixel_x = -6
	},
/obj/item/grenade/c4{
	pixel_x = -6
	},
/obj/structure/table/reinforced/plastitaniumglass,
/turf/open/floor/iron/dark/smooth_edge{
	dir = 8
	},
/area/shuttle/syndicate/airlock)
"oD" = (
/turf/open/floor/iron/dark/smooth_corner{
	dir = 1
	},
/area/shuttle/syndicate/hallway)
"oJ" = (
/obj/effect/turf_decal/syndicateemblem/middle/middle,
/turf/open/floor/mineral/plastitanium/red,
/area/shuttle/syndicate/hallway)
"pd" = (
/obj/machinery/porta_turret/syndicate/shuttle{
	dir = 5
	},
/turf/closed/wall/r_wall/syndicate,
/area/shuttle/syndicate/bridge)
"pg" = (
/obj/item/storage/box/handcuffs{
	pixel_x = 3;
	pixel_y = 3
	},
/obj/item/storage/box/zipties,
/obj/machinery/computer/security/telescreen/entertainment/directional/west,
/obj/structure/table/reinforced/plastitaniumglass,
/turf/open/floor/iron/dark/smooth_corner{
	dir = 2
	},
/area/shuttle/syndicate/airlock)
"pr" = (
/turf/open/floor/catwalk_floor/iron_dark,
/area/shuttle/syndicate/bridge)
"qQ" = (
/turf/open/floor/catwalk_floor/iron_dark,
/area/shuttle/syndicate/engineering)
"rd" = (
/obj/effect/turf_decal/tile/red/half{
	dir = 4
	},
/obj/structure/chair/office/tactical{
	dir = 8
	},
/turf/open/floor/iron/dark/smooth_edge{
	dir = 4
	},
/area/shuttle/syndicate/airlock)
"rA" = (
/obj/effect/turf_decal/tile/yellow{
	dir = 4
	},
/turf/open/floor/iron/dark/textured,
/area/shuttle/syndicate/engineering)
"ud" = (
/obj/machinery/nuclearbomb/syndicate{
	anchored = 1
	},
/obj/machinery/door/window/survival_pod{
	dir = 1
	},
/obj/effect/turf_decal/siding/red,
/obj/structure/railing,
/turf/open/floor/circuit/red,
/area/shuttle/syndicate/hallway)
"uo" = (
/obj/effect/turf_decal/syndicateemblem/top/middle,
/turf/open/floor/mineral/plastitanium/red,
/area/shuttle/syndicate/hallway)
"vv" = (
/turf/open/floor/iron/dark/smooth_corner{
	dir = 1
	},
/area/shuttle/syndicate/eva)
"wl" = (
/obj/effect/turf_decal/tile/blue,
/turf/open/floor/iron/corner,
/area/shuttle/syndicate/medical)
"wo" = (
/obj/effect/turf_decal/tile/red/half{
	dir = 8
	},
/turf/open/floor/iron/dark/smooth_edge{
	dir = 8
	},
/area/shuttle/syndicate/eva)
"xs" = (
/obj/effect/turf_decal/syndicateemblem/top/right,
/obj/machinery/newscaster/directional/east,
/turf/open/floor/mineral/plastitanium/red,
/area/shuttle/syndicate/hallway)
"xt" = (
/obj/effect/turf_decal/siding/thinplating_new/dark{
	dir = 4
	},
/obj/structure/sign/poster/contraband/random/directional/north,
/turf/open/floor/iron/dark/textured_corner{
	dir = 8
	},
/area/shuttle/syndicate/airlock)
"yo" = (
/obj/effect/turf_decal/tile/red/half{
	dir = 4
	},
/turf/open/floor/iron/dark/smooth_edge{
	dir = 4
	},
/area/shuttle/syndicate/airlock)
"zm" = (
/obj/machinery/sleeper/syndie{
	dir = 4
	},
/turf/open/floor/iron/dark/textured_large,
/area/shuttle/syndicate/medical)
"zJ" = (
/obj/effect/turf_decal/syndicateemblem/bottom/middle,
/turf/open/floor/mineral/plastitanium/red,
/area/shuttle/syndicate/hallway)
"zY" = (
/obj/structure/closet/syndicate/nuclear,
/obj/structure/railing,
/obj/effect/turf_decal/bot_red,
/turf/open/floor/mineral/plastitanium,
/area/shuttle/syndicate/airlock)
"BC" = (
/obj/effect/turf_decal/tile/red/half{
	dir = 4
	},
/turf/open/floor/iron/dark/smooth_edge{
	dir = 4
	},
/area/shuttle/syndicate/eva)
"BH" = (
/obj/machinery/door/airlock/external/ruin{
	req_access_txt = "150"
	},
/obj/effect/turf_decal/siding/thinplating_new/dark{
	dir = 4
	},
/obj/effect/turf_decal/siding/thinplating_new/dark/corner{
	dir = 1
	},
/obj/effect/mapping_helpers/airlock/autoname,
/turf/open/floor/mineral/plastitanium/red,
/area/shuttle/syndicate/airlock)
"Cg" = (
/obj/effect/turf_decal/siding/thinplating_new/dark{
	dir = 8
	},
/obj/effect/turf_decal/stripes/red/line{
	dir = 8
	},
/turf/open/floor/iron/dark/textured_edge{
	dir = 8
	},
/area/shuttle/syndicate/eva)
"Ch" = (
/turf/open/floor/catwalk_floor/iron_dark,
/area/shuttle/syndicate/hallway)
"CV" = (
/obj/effect/turf_decal/siding/thinplating_new/dark{
	dir = 8
	},
/obj/effect/turf_decal/siding/thinplating_new/dark/corner{
	dir = 4
	},
/obj/effect/mapping_helpers/airlock/autoname,
/obj/machinery/door/airlock/hatch{
	req_access_txt = "150"
	},
/turf/open/floor/mineral/plastitanium/red,
/area/shuttle/syndicate/eva)
"DT" = (
/obj/structure/chair/comfy/shuttle/tactical{
	dir = 4
	},
/turf/open/floor/iron/dark/smooth_edge{
	dir = 8
	},
/area/shuttle/syndicate/airlock)
"DW" = (
/obj/structure/chair/comfy/shuttle/tactical{
	dir = 8
	},
/turf/open/floor/iron/dark/smooth_edge{
	dir = 4
	},
/area/shuttle/syndicate/eva)
"Eh" = (
/obj/effect/turf_decal/tile/red/half{
	dir = 8
	},
/turf/open/floor/iron/dark/smooth_edge{
	dir = 8
	},
/area/shuttle/syndicate/airlock)
"In" = (
/obj/machinery/porta_turret/syndicate/shuttle{
	dir = 6
	},
/turf/closed/wall/r_wall/syndicate,
/area/shuttle/syndicate/hallway)
"IR" = (
/obj/effect/turf_decal/syndicateemblem/middle/right,
/turf/open/floor/mineral/plastitanium/red,
/area/shuttle/syndicate/hallway)
"JA" = (
/obj/machinery/porta_turret/syndicate/shuttle{
	dir = 5
	},
/turf/closed/wall/r_wall/syndicate,
/area/shuttle/syndicate/airlock)
"MJ" = (
/obj/machinery/porta_turret/syndicate/shuttle{
	dir = 6
	},
/turf/closed/wall/r_wall/syndicate,
/area/shuttle/syndicate/medical)
"MX" = (
/obj/machinery/computer/security/telescreen/entertainment/directional/south,
/turf/open/floor/iron/dark,
/area/shuttle/syndicate/bridge)
"Nh" = (
/obj/structure/rack,
/obj/item/toy/plush/nukeplushie,
/obj/effect/turf_decal/siding/thinplating_new{
	dir = 6
	},
/obj/structure/railing{
	dir = 6
	},
/turf/open/floor/iron/dark/textured_large,
/area/shuttle/syndicate/medical)
"Nk" = (
/obj/effect/turf_decal/syndicateemblem/middle/left,
/turf/open/floor/mineral/plastitanium/red,
/area/shuttle/syndicate/hallway)
"Pm" = (
/obj/machinery/computer/secure_data/laptop/syndie,
/obj/structure/table/reinforced/plastitaniumglass,
/turf/open/floor/iron/dark,
/area/shuttle/syndicate/airlock)
"Qj" = (
/obj/machinery/computer/station_alert{
	dir = 8
	},
/obj/effect/turf_decal/tile/red/anticorner,
/turf/open/floor/iron/dark/smooth_corner{
	dir = 1
	},
/area/shuttle/syndicate/bridge)
"Sz" = (
/obj/effect/turf_decal/siding/thinplating_new/dark{
	dir = 4
	},
/turf/open/floor/iron/dark/textured_edge{
	dir = 4
	},
/area/shuttle/syndicate/airlock)
"UF" = (
/obj/machinery/newscaster/directional/south,
/turf/open/floor/iron/dark,
/area/shuttle/syndicate/bridge)
"Ve" = (
/obj/effect/decal/cleanable/generic,
/obj/effect/decal/cleanable/glass,
/obj/item/toy/nuke,
/turf/open/floor/fakespace,
/area/shuttle/syndicate/hallway)
"Zo" = (
/turf/open/floor/iron/dark/smooth_corner{
	dir = 4
	},
/area/shuttle/syndicate/hallway)

(1,1,1) = {"
aa
aa
aa
aa
aa
aa
aa
aa
aa
aa
aa
aa
aa
aG
aJ
aJ
aJ
aJ
aJ
aJ
aJ
aJ
aJ
"}
(2,1,1) = {"
aa
aa
aa
aa
aa
aa
aa
aw
ax
ax
ax
ax
ax
aJ
zm
bC
bq
bR
bY
cj
co
cu
cz
"}
(3,1,1) = {"
aa
aa
aa
aa
aa
aa
aa
ax
be
be
be
aR
be
aJ
br
bD
wl
jk
bZ
bH
cp
cu
cA
"}
(4,1,1) = {"
aa
aa
aa
aa
aa
aa
aa
ax
kx
Cg
Cg
Cg
aM
aJ
bs
Nh
jk
bS
ca
ck
cq
cu
cB
"}
(5,1,1) = {"
ab
ac
ac
ac
ac
aa
aa
ax
aZ
wo
BC
wo
aZ
aJ
bt
ca
bZ
ca
cb
aK
aJ
aJ
MJ
"}
(6,1,1) = {"
ac
ag
an
at
ac
ad
aa
ax
aN
aS
aU
DW
vv
aJ
bu
ca
ca
ca
cc
aJ
aa
aa
aa
"}
(7,1,1) = {"
ae
ah
ao
UF
ac
af
af
ax
ax
ax
ax
bg
CV
aK
bv
aJ
bK
bv
aJ
aJ
af
af
aa
"}
(8,1,1) = {"
ae
ai
pr
ap
ac
ay
aC
aH
aD
aD
aV
Zo
fI
bf
Nk
bE
bL
bU
az
cl
cr
cv
aa
"}
(9,1,1) = {"
ae
aj
aq
ap
av
aD
Ch
Ch
Ch
aD
aW
aD
fI
uo
oJ
zJ
bL
aD
ud
bo
cr
cw
aa
"}
(10,1,1) = {"
ae
ak
pr
ap
ac
aA
aD
aI
aD
aD
aV
oD
fI
xs
IR
bF
bL
mZ
az
Ve
cr
cx
aa
"}
(11,1,1) = {"
ae
al
ar
MX
ac
af
af
aB
aB
aB
aB
bh
BH
bj
bw
bm
bM
bw
bm
bm
af
af
aa
"}
(12,1,1) = {"
ac
am
as
Qj
ac
In
aa
aB
pg
nH
aX
DT
aO
bm
bx
bG
ch
bV
ce
bm
aa
aa
aa
"}
(13,1,1) = {"
pd
ac
ac
ac
ac
aa
aa
aB
Pm
rd
Eh
yo
bc
bm
by
ch
qQ
qQ
cf
bj
bm
bm
dp
"}
(14,1,1) = {"
aa
aa
aa
aa
aa
aa
aa
aB
xt
Sz
Sz
Sz
aP
bm
bz
ch
bO
bW
cg
bP
cs
cy
cE
"}
(15,1,1) = {"
aa
aa
aa
aa
aa
aa
aa
aB
aQ
zY
aT
bi
bi
bm
bA
ch
qQ
qQ
ch
jt
ct
cy
cF
"}
(16,1,1) = {"
aa
aa
aa
aa
aa
aa
aa
JA
aB
aB
aY
bd
aB
bm
bB
rA
ch
ch
ci
cn
cs
cy
cG
"}
(17,1,1) = {"
aa
aa
aa
aa
aa
aa
aa
aa
aa
aa
aa
aa
aa
aF
bm
bm
bm
bm
bm
bm
bm
bm
bm
"}
