//MAP CONVERTED BY dmm2tgm.py THIS HEADER COMMENT PREVENTS RECONVERSION, DO NOT REMOVE
"a" = (
/turf/closed/wall/mineral/titanium,
/area/shuttle/labor)
"c" = (
/obj/effect/decal/cleanable/dirt,
/obj/effect/turf_decal/delivery,
/obj/structure/closet/crate,
/turf/open/floor/iron/smooth,
/area/shuttle/labor)
"d" = (
/obj/machinery/button/flasher{
	id = "gulagshuttleflasher";
	name = "Flash Control";
	pixel_y = -26;
	req_access = list("security")
	},
/obj/effect/turf_decal/trimline/red/line,
/obj/machinery/light/dim/directional/south,
/turf/open/floor/mineral/plastitanium,
/area/shuttle/labor)
"f" = (
/obj/machinery/door/airlock/shuttle{
	id_tag = "prisonshuttle";
	name = "Labor Shuttle Airlock"
	},
/obj/effect/turf_decal/stripes/line{
	dir = 8
	},
/obj/effect/turf_decal/stripes/line{
	dir = 4
	},
/obj/docking_port/mobile{
	dir = 8;
	name = "labor camp shuttle";
	port_direction = 4;
	shuttle_id = "laborcamp"
	},
/turf/open/floor/iron/smooth,
/area/shuttle/labor)
"g" = (
/obj/item/folder/red,
/obj/item/restraints/handcuffs,
/obj/structure/table/reinforced,
/turf/open/floor/mineral/plastitanium,
/area/shuttle/labor)
"h" = (
/obj/structure/chair/comfy/shuttle{
	dir = 4
	},
/obj/effect/turf_decal/trimline/red/filled/line{
	dir = 10
	},
/obj/effect/turf_decal/stripes/line{
	dir = 10
	},
/obj/effect/decal/cleanable/dirt,
/turf/open/floor/iron/textured,
/area/shuttle/labor)
"i" = (
/obj/effect/decal/cleanable/dirt,
/obj/effect/turf_decal/loading_area{
	dir = 4
	},
/turf/open/floor/iron/smooth,
/area/shuttle/labor)
"j" = (
/obj/machinery/computer/shuttle/labor{
	dir = 4
	},
/obj/structure/reagent_dispensers/wall/peppertank/directional/west,
/obj/effect/turf_decal/bot,
/turf/open/floor/mineral/plastitanium,
/area/shuttle/labor)
"k" = (
/obj/machinery/door/airlock/shuttle{
	name = "Labor Shuttle Airlock"
	},
/obj/effect/turf_decal/stripes/line,
/obj/effect/mapping_helpers/airlock/access/all/security/brig,
/obj/effect/turf_decal/trimline/red/filled/warning,
/obj/effect/turf_decal/trimline/red/filled/warning{
	dir = 1
	},
/turf/open/floor/mineral/plastitanium,
/area/shuttle/labor)
"l" = (
/obj/machinery/power/shuttle_engine/heater,
/obj/structure/window/reinforced/spawner/directional/north,
/obj/effect/turf_decal/stripes/line,
/turf/open/floor/plating/airless,
/area/shuttle/labor)
"n" = (
/obj/machinery/power/shuttle_engine/propulsion,
/obj/effect/turf_decal/stripes/line,
/turf/open/floor/plating/airless,
/area/shuttle/labor)
"o" = (
/obj/effect/decal/cleanable/dirt,
/obj/effect/turf_decal/trimline/red/filled/line{
	dir = 1
	},
/obj/effect/turf_decal/stripes/line{
	dir = 1
	},
/turf/open/floor/iron/textured,
/area/shuttle/labor)
"p" = (
/obj/machinery/door/airlock/shuttle{
	name = "Labor Shuttle Airlock"
	},
/obj/effect/turf_decal/stripes/line{
	dir = 8
	},
/obj/effect/turf_decal/stripes/line{
	dir = 4
	},
/obj/effect/mapping_helpers/airlock/access/all/security/brig,
/turf/open/floor/mineral/plastitanium,
/area/shuttle/labor)
"q" = (
/obj/effect/turf_decal/trimline/red/filled/line{
	dir = 9
	},
/obj/effect/turf_decal/stripes/line{
	dir = 9
	},
/obj/structure/chair/comfy/shuttle{
	dir = 4
	},
/obj/machinery/light/dim/directional/north,
/turf/open/floor/iron/textured,
/area/shuttle/labor)
"r" = (
/turf/closed/wall/mineral/plastitanium,
/area/shuttle/labor)
"v" = (
/obj/machinery/mineral/stacking_unit_console{
	pixel_x = 30;
	pixel_y = 30
	},
/obj/effect/turf_decal/tile/red/half{
	dir = 4
	},
/turf/open/floor/mineral/plastitanium,
/area/shuttle/labor)
"z" = (
/obj/machinery/mineral/labor_claim_console{
	pixel_x = 30
	},
/obj/effect/decal/cleanable/dirt,
/obj/structure/chair/comfy/shuttle{
	dir = 8
	},
/obj/effect/turf_decal/trimline/red/filled/line{
	dir = 5
	},
/obj/effect/turf_decal/stripes/line{
	dir = 5
	},
/obj/effect/turf_decal/arrows{
	dir = 1;
	pixel_x = -7;
	pixel_y = -8
	},
/obj/effect/turf_decal/arrows{
	dir = 1;
	pixel_x = 7;
	pixel_y = -8
	},
/turf/open/floor/iron/textured,
/area/shuttle/labor)
"C" = (
/obj/effect/spawner/structure/window/reinforced/shuttle,
/turf/open/floor/plating,
/area/shuttle/labor)
"F" = (
/turf/closed/wall/mineral/titanium/nodiagonal,
/area/shuttle/labor)
"G" = (
/obj/machinery/mineral/stacking_machine/laborstacker{
	input_dir = 2;
	output_dir = 1
	},
/obj/effect/turf_decal/stripes/line,
/obj/effect/decal/cleanable/dirt,
/obj/effect/turf_decal/trimline/red/filled/warning{
	dir = 1
	},
/turf/open/floor/mineral/plastitanium,
/area/shuttle/labor)
"I" = (
/obj/effect/turf_decal/bot,
/turf/open/floor/iron/smooth,
/area/shuttle/labor)
"J" = (
/obj/structure/chair/comfy/shuttle{
	dir = 8
	},
/obj/machinery/flasher/directional/east{
	id = "gulagshuttleflasher"
	},
/obj/effect/turf_decal/trimline/red/filled/line{
	dir = 6
	},
/obj/effect/turf_decal/stripes/line{
	dir = 6
	},
/turf/open/floor/iron/textured,
/area/shuttle/labor)
"N" = (
/obj/effect/turf_decal/trimline/red/line{
	dir = 4
	},
/obj/structure/chair/comfy/shuttle{
	dir = 1
	},
/turf/open/floor/mineral/plastitanium,
/area/shuttle/labor)
"V" = (
/obj/effect/turf_decal/trimline/red/line{
	dir = 6
	},
/turf/open/floor/mineral/plastitanium,
/area/shuttle/labor)
"X" = (
/obj/effect/turf_decal/trimline/red/filled/line,
/obj/effect/turf_decal/stripes/line,
/obj/effect/decal/cleanable/dirt,
/turf/open/floor/iron/textured,
/area/shuttle/labor)
"Z" = (
/turf/closed/wall/mineral/plastitanium/nodiagonal,
/area/shuttle/labor)

(1,1,1) = {"
a
a
C
a
a
C
a
Z
r
"}
(2,1,1) = {"
C
j
d
F
q
h
c
r
n
"}
(3,1,1) = {"
C
N
V
k
o
X
i
l
n
"}
(4,1,1) = {"
C
g
v
G
z
J
I
r
n
"}
(5,1,1) = {"
a
a
p
a
a
a
f
Z
r
"}
