//MAP CONVERTED BY dmm2tgm.py THIS HEADER COMMENT PREVENTS RECONVERSION, DO NOT REMOVE
"a" = (
/turf/closed/wall/mineral/titanium,
/area/space)
"j" = (
/obj/effect/mapping_helpers/airlock/access/all/security/brig,
/obj/machinery/door/airlock/titanium{
	name = "Labor Shuttle Airlock"
	},
/turf/open/floor/mineral/plastitanium/red,
/area/space)
"o" = (
/obj/machinery/power/shuttle_engine/propulsion,
/turf/open/floor/plating/airless,
/area/space)
"p" = (
/turf/open/floor/mineral/plastitanium/red,
/area/space)
"q" = (
/obj/structure/chair/office{
	dir = 1
	},
/turf/open/floor/mineral/plastitanium/red,
/area/space)
"s" = (
/obj/effect/spawner/structure/window/reinforced/shuttle,
/turf/open/floor/plating,
/area/space)
"u" = (
/obj/machinery/door/airlock/titanium{
	name = "Labor Shuttle Airlock"
	},
/obj/effect/mapping_helpers/airlock/access/all/security/brig,
/turf/open/floor/mineral/plastitanium/red,
/area/space)
"v" = (
/obj/machinery/mineral/stacking_unit_console{
	pixel_x = 30
	},
/obj/structure/chair/office{
	dir = 8
	},
/turf/open/floor/mineral/plastitanium/red,
/area/space)
"z" = (
/obj/machinery/power/shuttle_engine/heater,
/obj/structure/window/reinforced/spawner/directional/north{
	layer = 2.9
	},
/turf/open/floor/plating/airless,
/area/space)
"B" = (
/obj/structure/chair/comfy/shuttle{
	dir = 8
	},
/obj/machinery/flasher/directional/east{
	id = "gulagshuttleflasher"
	},
/turf/open/floor/mineral/titanium,
/area/space)
"C" = (
/obj/machinery/mineral/labor_claim_console{
	pixel_x = 30
	},
/turf/open/floor/mineral/titanium,
/area/space)
"F" = (
/obj/machinery/computer/shuttle/labor/selene{
	dir = 4
	},
/obj/structure/reagent_dispensers/wall/peppertank/directional/west,
/turf/open/floor/mineral/plastitanium/red,
/area/space)
"J" = (
/obj/structure/closet/crate,
/turf/open/floor/mineral/titanium,
/area/space)
"K" = (
/obj/machinery/mineral/stacking_machine/laborstacker{
	input_dir = 2;
	output_dir = 1
	},
/turf/open/floor/iron/dark,
/area/space)
"M" = (
/obj/machinery/button/flasher{
	id = "gulagshuttleflasher";
	name = "Flash Control";
	pixel_y = -26;
	req_access = list("security")
	},
/obj/machinery/light/directional/south,
/turf/open/floor/mineral/plastitanium/red,
/area/space)
"N" = (
/turf/open/floor/mineral/titanium,
/area/space)
"Q" = (
/obj/docking_port/mobile{
	dir = 8;
	name = "labor camp shuttle";
	port_direction = 4;
	shuttle_id = "laborcamp"
	},
/obj/machinery/door/airlock/titanium{
	name = "Labor Shuttle Airlock"
	},
/turf/open/floor/plating,
/area/space)
"U" = (
/obj/machinery/light/directional/north,
/turf/open/floor/mineral/titanium,
/area/space)

(1,1,1) = {"
a
a
a
a
a
s
a
a
a
"}
(2,1,1) = {"
s
F
p
u
N
J
N
z
o
"}
(3,1,1) = {"
s
q
M
a
U
N
N
z
o
"}
(4,1,1) = {"
s
p
v
K
C
B
N
z
o
"}
(5,1,1) = {"
a
j
a
a
a
a
Q
a
a
"}
