//MAP CONVERTED BY dmm2tgm.py THIS HEADER COMMENT PREVENTS RECONVERSION, DO NOT REMOVE
"a" = (
/turf/closed/wall/mineral/titanium,
/area/shuttle/labor)
"b" = (
/obj/effect/spawner/structure/window/shuttle,
/turf/open/floor/plating,
/area/shuttle/labor)
"c" = (
/obj/machinery/door/airlock/titanium{
	id_tag = "prisonshuttle";
	name = "Labor Shuttle Airlock"
	},
/obj/docking_port/mobile{
	dwidth = 2;
	height = 6;
	id = "laborcamp";
	name = "labor camp shuttle";
	port_direction = 4;
	width = 11
	},
/turf/open/floor/mineral/titanium,
/area/shuttle/labor)
"d" = (
/obj/item/clothing/suit/hazardvest{
	desc = "A high-visibility lifejacket complete with whistle and slot for oxygen tanks.";
	name = "emergency lifejacket"
	},
/obj/item/clothing/suit/hazardvest{
	desc = "A high-visibility lifejacket complete with whistle and slot for oxygen tanks.";
	name = "emergency lifejacket"
	},
/obj/item/clothing/suit/hazardvest{
	desc = "A high-visibility lifejacket complete with whistle and slot for oxygen tanks.";
	name = "emergency lifejacket"
	},
/obj/item/clothing/suit/hazardvest{
	desc = "A high-visibility lifejacket complete with whistle and slot for oxygen tanks.";
	name = "emergency lifejacket"
	},
/obj/item/clothing/suit/hazardvest{
	desc = "A high-visibility lifejacket complete with whistle and slot for oxygen tanks.";
	name = "emergency lifejacket"
	},
/obj/item/tank/internals/emergency_oxygen{
	pixel_x = 3
	},
/obj/item/tank/internals/emergency_oxygen{
	pixel_x = 3
	},
/obj/item/tank/internals/emergency_oxygen{
	pixel_x = 3
	},
/obj/item/tank/internals/emergency_oxygen{
	pixel_x = 3
	},
/obj/item/tank/internals/emergency_oxygen{
	pixel_x = 3
	},
/obj/item/clothing/mask/breath{
	pixel_x = -3;
	pixel_y = -3
	},
/obj/item/clothing/mask/breath{
	pixel_x = -3;
	pixel_y = -3
	},
/obj/item/clothing/mask/breath{
	pixel_x = -3;
	pixel_y = -3
	},
/obj/item/clothing/mask/breath{
	pixel_x = -3;
	pixel_y = -3
	},
/obj/item/clothing/mask/breath{
	pixel_x = -3;
	pixel_y = -3
	},
/obj/item/clothing/head/hardhat/orange{
	name = "protective hat";
	pixel_y = 9
	},
/obj/item/clothing/head/hardhat/orange{
	name = "protective hat";
	pixel_y = 9
	},
/obj/item/clothing/head/hardhat/orange{
	name = "protective hat";
	pixel_y = 9
	},
/obj/item/clothing/head/hardhat/orange{
	name = "protective hat";
	pixel_y = 9
	},
/obj/item/clothing/head/hardhat/orange{
	name = "protective hat";
	pixel_y = 9
	},
/obj/structure/closet/crate/internals,
/obj/effect/decal/cleanable/dirt,
/obj/effect/turf_decal/delivery,
/turf/open/floor/plasteel,
/area/shuttle/labor)
"e" = (
/obj/machinery/light{
	dir = 1
	},
/turf/open/floor/mineral/titanium,
/area/shuttle/labor)
"f" = (
/turf/open/floor/mineral/titanium,
/area/shuttle/labor)
"g" = (
/obj/structure/shuttle/engine/heater{
	dir = 4
	},
/obj/structure/window/reinforced{
	dir = 8
	},
/turf/open/floor/plating/airless,
/area/shuttle/labor)
"h" = (
/obj/structure/shuttle/engine/propulsion{
	dir = 4;
	icon_state = "propulsion"
	},
/turf/open/floor/plating/airless,
/area/shuttle/labor)
"i" = (
/obj/machinery/computer/shuttle/labor{
	dir = 4
	},
/turf/open/floor/mineral/plastitanium/red,
/area/shuttle/labor)
"j" = (
/obj/structure/chair/comfy/shuttle{
	dir = 8
	},
/turf/open/floor/mineral/plastitanium/red,
/area/shuttle/labor)
"k" = (
/obj/machinery/door/airlock/titanium{
	name = "Labor Shuttle Airlock";
	req_access_txt = "2"
	},
/turf/open/floor/mineral/plastitanium/red,
/area/shuttle/labor)
"l" = (
/obj/structure/table/reinforced,
/turf/open/floor/mineral/plastitanium/red,
/area/shuttle/labor)
"m" = (
/obj/machinery/light{
	dir = 1
	},
/obj/structure/reagent_dispensers/peppertank{
	pixel_y = 32
	},
/obj/machinery/button/flasher{
	id = "gulagshuttleflasher";
	name = "Flash Control";
	pixel_x = -25;
	req_access_txt = "1"
	},
/turf/open/floor/mineral/plastitanium/red,
/area/shuttle/labor)
"n" = (
/obj/machinery/mineral/labor_claim_console{
	machinedir = 1;
	pixel_x = 30
	},
/turf/open/floor/mineral/plastitanium/red,
/area/shuttle/labor)
"p" = (
/obj/structure/closet/crate,
/turf/open/floor/mineral/plastitanium/red,
/area/shuttle/labor)
"q" = (
/obj/machinery/mineral/stacking_machine/laborstacker{
	input_dir = 2;
	output_dir = 1
	},
/turf/open/floor/mineral/titanium,
/area/shuttle/labor)
"r" = (
/turf/open/floor/mineral/plastitanium/red,
/area/shuttle/labor)
"s" = (
/turf/closed/wall/mineral/titanium/nodiagonal,
/area/shuttle/labor)
"w" = (
/obj/structure/chair/comfy/shuttle{
	dir = 8
	},
/turf/open/floor/mineral/titanium,
/area/shuttle/labor)
"z" = (
/obj/structure/chair/comfy/shuttle{
	dir = 8
	},
/obj/machinery/mineral/labor_claim_console{
	machinedir = 1;
	pixel_y = -30
	},
/turf/open/floor/mineral/titanium,
/area/shuttle/labor)
"A" = (
/obj/structure/table/reinforced,
/turf/open/floor/mineral/titanium,
/area/shuttle/labor)
"C" = (
/obj/machinery/flasher{
	id = "gulagshuttleflasher";
	pixel_x = -25
	},
/turf/open/floor/mineral/titanium,
/area/shuttle/labor)
"Z" = (
/obj/machinery/door/airlock/shuttle{
	name = "Labor Shuttle Airlock";
	req_access_txt = "2"
	},
/turf/open/floor/mineral/titanium,
/area/shuttle/labor)

(1,1,1) = {"
a
a
b
b
a
a
"}
(2,1,1) = {"
a
l
i
p
r
a
"}
(3,1,1) = {"
a
m
j
r
r
a
"}
(4,1,1) = {"
k
n
r
r
r
a
"}
(5,1,1) = {"
a
a
s
q
Z
a
"}
(6,1,1) = {"
a
d
C
f
f
a
"}
(7,1,1) = {"
a
e
f
f
f
a
"}
(8,1,1) = {"
a
f
f
f
f
a
"}
(9,1,1) = {"
c
f
w
z
A
a
"}
(10,1,1) = {"
a
g
g
g
g
a
"}
(11,1,1) = {"
a
h
h
h
h
a
"}
