//MAP CONVERTED BY dmm2tgm.py THIS HEADER COMMENT PREVENTS RECONVERSION, DO NOT REMOVE
"a" = (
/turf/closed/wall/mineral/titanium,
/area/shuttle/mining)
"b" = (
/obj/effect/spawner/structure/window/shuttle,
/turf/open/floor/plating,
/area/shuttle/mining)
"c" = (
/obj/structure/closet/emcloset,
/turf/open/floor/mineral/titanium/white,
/area/shuttle/mining)
"d" = (
/obj/machinery/computer/shuttle/mining,
/turf/open/floor/mineral/titanium/white,
/area/shuttle/mining)
"g" = (
/turf/open/floor/mineral/titanium/white,
/area/shuttle/mining)
"h" = (
/obj/machinery/door/airlock/titanium{
	name = "Mining Shuttle Airlock"
	},
/obj/docking_port/mobile{
	dir = 8;
	dwidth = 3;
	height = 5;
	id = "mining";
	name = "mining shuttle";
	port_direction = 4;
	width = 7
	},
/turf/open/floor/mineral/titanium/white,
/area/shuttle/mining)
"i" = (
/obj/structure/window/reinforced{
	dir = 4;
	layer = 3;
	pixel_x = 3
	},
/obj/structure/ore_box,
/turf/open/floor/plating,
/area/shuttle/mining)
"j" = (
/obj/structure/shuttle/engine/heater,
/obj/structure/window/reinforced{
	dir = 1
	},
/turf/open/floor/plating,
/area/shuttle/mining)
"k" = (
/obj/structure/window/reinforced{
	dir = 8;
	layer = 3;
	pixel_x = -3
	},
/obj/structure/ore_box,
/turf/open/floor/plating,
/area/shuttle/mining)
"l" = (
/obj/structure/shuttle/engine/propulsion,
/turf/open/floor/plating,
/area/shuttle/mining)
"I" = (
/obj/structure/table,
/turf/open/floor/mineral/titanium/white,
/area/shuttle/mining)
"Q" = (
/obj/structure/chair/comfy/shuttle{
	dir = 1
	},
/turf/open/floor/mineral/titanium/white,
/area/shuttle/mining)

(1,1,1) = {"
a
a
b
a
b
a
a
"}
(2,1,1) = {"
b
c
g
g
Q
i
a
"}
(3,1,1) = {"
b
d
Q
g
Q
j
l
"}
(4,1,1) = {"
b
I
g
g
Q
k
a
"}
(5,1,1) = {"
a
a
b
h
b
a
a
"}
