//MAP CONVERTED BY dmm2tgm.py THIS HEADER COMMENT PREVENTS RECONVERSION, DO NOT REMOVE
"b" = (
/turf/closed/wall/mineral/titanium,
/area/shuttle/prison_shuttle)
"c" = (
/obj/effect/turf_decal/trimline/red/line{
	dir = 1
	},
/obj/effect/turf_decal/trimline/red/line,
/turf/open/floor/iron/dark/textured,
/area/shuttle/prison_shuttle)
"f" = (
/obj/effect/turf_decal/trimline/brown/end{
	dir = 4
	},
/turf/open/floor/iron/dark/textured,
/area/shuttle/prison_shuttle)
"g" = (
/obj/machinery/door/airlock/titanium{
	name = "Prison Ship Airlock"
	},
/turf/open/floor/iron/dark/textured,
/area/shuttle/prison_shuttle)
"h" = (
/obj/machinery/light/directional/east,
/obj/effect/turf_decal/trimline/red/end{
	dir = 4
	},
/turf/open/floor/iron/dark/textured,
/area/shuttle/prison_shuttle)
"i" = (
/obj/docking_port/mobile/prison,
/obj/machinery/door/airlock/titanium{
	name = "Prison Ship Airlock"
	},
/turf/open/floor/iron/dark/textured,
/area/shuttle/prison_shuttle)
"j" = (
/obj/machinery/disposal/bin/prison/medical,
/obj/effect/turf_decal/trimline/blue/line,
/obj/effect/turf_decal/trimline/blue/line{
	dir = 1
	},
/turf/open/floor/iron/dark/textured,
/area/shuttle/prison_shuttle)
"k" = (
/obj/effect/turf_decal/trimline/blue/line{
	dir = 1
	},
/obj/effect/turf_decal/trimline/blue/line,
/turf/open/floor/iron/dark/textured,
/area/shuttle/prison_shuttle)
"l" = (
/obj/effect/turf_decal/trimline/yellow/line{
	dir = 1
	},
/obj/effect/turf_decal/trimline/yellow/line,
/turf/open/floor/iron/dark/textured,
/area/shuttle/prison_shuttle)
"m" = (
/obj/machinery/disposal/bin/prison/supply,
/obj/effect/turf_decal/trimline/brown/line,
/obj/effect/turf_decal/trimline/brown/line{
	dir = 1
	},
/turf/open/floor/iron/dark/textured,
/area/shuttle/prison_shuttle)
"q" = (
/obj/structure/window/reinforced{
	dir = 1
	},
/obj/structure/shuttle/engine/heater,
/turf/open/floor/plating/airless,
/area/shuttle/prison_shuttle)
"s" = (
/turf/template_noop,
/area/template_noop)
"t" = (
/obj/structure/shuttle/engine/propulsion/burst/left,
/turf/open/floor/plating/airless,
/area/shuttle/prison_shuttle)
"u" = (
/obj/structure/shuttle/engine/propulsion,
/turf/open/floor/plating/airless,
/area/shuttle/prison_shuttle)
"v" = (
/obj/structure/shuttle/engine/propulsion/burst/right,
/turf/open/floor/plating/airless,
/area/shuttle/prison_shuttle)
"w" = (
/obj/structure/closet/crate/mail/prison/prison_mail,
/turf/open/floor/iron/dark/textured,
/area/shuttle/prison_shuttle)
"x" = (
/obj/effect/turf_decal/trimline/purple/line{
	dir = 1
	},
/obj/effect/turf_decal/trimline/purple/line,
/turf/open/floor/iron/dark/textured,
/area/shuttle/prison_shuttle)
"y" = (
/obj/machinery/disposal/bin/prison/service,
/obj/effect/turf_decal/trimline/green/line,
/obj/effect/turf_decal/trimline/green/line{
	dir = 1
	},
/turf/open/floor/iron/dark/textured,
/area/shuttle/prison_shuttle)
"z" = (
/turf/open/floor/iron/dark/textured,
/area/shuttle/prison_shuttle)
"C" = (
/obj/machinery/disposal/bin/prison/engineering,
/obj/effect/turf_decal/trimline/yellow/line,
/obj/effect/turf_decal/trimline/yellow/line{
	dir = 1
	},
/turf/open/floor/iron/dark/textured,
/area/shuttle/prison_shuttle)
"F" = (
/obj/machinery/light/directional/east,
/obj/effect/turf_decal/trimline/green/end{
	dir = 4
	},
/turf/open/floor/iron/dark/textured,
/area/shuttle/prison_shuttle)
"G" = (
/obj/machinery/light/directional/east,
/obj/structure/closet/crate/mail/prison/prison_mail,
/turf/open/floor/iron/dark/textured,
/area/shuttle/prison_shuttle)
"H" = (
/obj/effect/turf_decal/trimline/yellow/end{
	dir = 4
	},
/turf/open/floor/iron/dark/textured,
/area/shuttle/prison_shuttle)
"I" = (
/obj/effect/turf_decal/trimline/red/line,
/obj/effect/turf_decal/trimline/red/line{
	dir = 1
	},
/turf/open/floor/iron/dark/textured,
/area/shuttle/prison_shuttle)
"J" = (
/obj/effect/turf_decal/trimline/yellow/line,
/obj/effect/turf_decal/trimline/yellow/line{
	dir = 1
	},
/turf/open/floor/iron/dark/textured,
/area/shuttle/prison_shuttle)
"L" = (
/obj/effect/turf_decal/trimline/purple/end{
	dir = 4
	},
/turf/open/floor/iron/dark/textured,
/area/shuttle/prison_shuttle)
"M" = (
/obj/item/radio/intercom/prison/directional/east,
/turf/open/floor/iron/dark/textured,
/area/shuttle/prison_shuttle)
"Q" = (
/obj/effect/turf_decal/trimline/brown/line{
	dir = 1
	},
/obj/effect/turf_decal/trimline/brown/line,
/turf/open/floor/iron/dark/textured,
/area/shuttle/prison_shuttle)
"S" = (
/obj/machinery/light/directional/west,
/turf/open/floor/iron/dark/textured,
/area/shuttle/prison_shuttle)
"V" = (
/obj/machinery/disposal/bin/prison/security,
/obj/effect/turf_decal/trimline/red/line,
/obj/effect/turf_decal/trimline/red/line{
	dir = 1
	},
/turf/open/floor/iron/dark/textured,
/area/shuttle/prison_shuttle)
"W" = (
/obj/machinery/light/directional/west,
/obj/machinery/disposal/bin/prison/science,
/obj/effect/turf_decal/trimline/purple/line,
/obj/effect/turf_decal/trimline/purple/line{
	dir = 1
	},
/turf/open/floor/iron/dark/textured,
/area/shuttle/prison_shuttle)
"X" = (
/obj/effect/turf_decal/trimline/green/line{
	dir = 1
	},
/obj/effect/turf_decal/trimline/green/line,
/turf/open/floor/iron/dark/textured,
/area/shuttle/prison_shuttle)
"Z" = (
/obj/effect/turf_decal/trimline/blue/end{
	dir = 4
	},
/turf/open/floor/iron/dark/textured,
/area/shuttle/prison_shuttle)

(1,1,1) = {"
b
b
b
b
b
b
b
b
b
b
b
s
"}
(2,1,1) = {"
b
V
C
W
j
y
m
S
z
w
b
t
"}
(3,1,1) = {"
b
I
J
x
k
X
Q
z
z
w
q
u
"}
(4,1,1) = {"
b
c
l
x
k
X
Q
z
z
w
q
u
"}
(5,1,1) = {"
b
c
l
x
k
X
Q
z
z
w
q
u
"}
(6,1,1) = {"
b
h
H
L
Z
F
f
M
z
G
b
v
"}
(7,1,1) = {"
b
b
b
b
g
b
i
b
b
b
b
s
"}
