//MAP CONVERTED BY dmm2tgm.py THIS HEADER COMMENT PREVENTS RECONVERSION, DO NOT REMOVE
"ar" = (
/obj/structure/table/wood/fancy/black,
/obj/machinery/light/directional/east,
/turf/open/floor/carpet/royalblack,
/area/shuttle/abandoned/engine)
"ax" = (
/obj/structure/bed/dogbed,
/obj/item/clothing/neck/petcollar,
/turf/open/floor/carpet/purple,
/area/shuttle/abandoned/crew)
"aE" = (
/obj/structure/table/wood,
/turf/open/floor/carpet/purple,
/area/shuttle/abandoned/crew)
"bF" = (
/obj/machinery/seed_extractor,
/turf/open/floor/engine,
/area/shuttle/abandoned/cargo)
"bL" = (
/turf/closed/wall/mineral/titanium,
/area/shuttle/abandoned/engine)
"bQ" = (
/obj/machinery/light/directional/north,
/turf/open/floor/carpet/purple,
/area/shuttle/abandoned/crew)
"bU" = (
/obj/machinery/plumbing/tank,
/turf/open/floor/engine,
/area/shuttle/abandoned/medbay)
"ct" = (
/mob/living/simple_animal/hostile/pirate/ranged/space,
/turf/open/floor/engine,
/area/shuttle/abandoned/medbay)
"cy" = (
/obj/machinery/smartfridge/drying_rack,
/turf/open/floor/engine,
/area/shuttle/abandoned/cargo)
"cL" = (
/turf/open/floor/carpet/purple,
/area/shuttle/abandoned/crew)
"dh" = (
/obj/effect/spawner/structure/window/reinforced,
/turf/open/floor/engine,
/area/shuttle/abandoned/medbay)
"dX" = (
/obj/structure/chair/comfy/shuttle{
	dir = 1
	},
/turf/open/floor/carpet/royalblack,
/area/shuttle/abandoned/engine)
"em" = (
/turf/open/floor/plating/airless,
/area/shuttle/abandoned/cargo)
"ey" = (
/obj/structure/closet/wardrobe,
/obj/item/clothing/under/dress/skirt,
/obj/item/clothing/under/dress/skirt,
/obj/item/clothing/under/dress/skirt,
/obj/item/clothing/under/dress/striped,
/turf/open/floor/carpet/purple,
/area/shuttle/abandoned/crew)
"fk" = (
/turf/closed/wall/mineral/titanium,
/area/shuttle/abandoned/bar)
"gw" = (
/obj/machinery/smartfridge/drying_rack,
/turf/open/floor/engine,
/area/shuttle/abandoned/medbay)
"gY" = (
/obj/structure/table/reinforced,
/turf/open/floor/engine,
/area/shuttle/abandoned/medbay)
"hd" = (
/obj/structure/table/wood/fancy/black,
/obj/item/pai_card,
/obj/machinery/light/directional/west,
/turf/open/floor/carpet/royalblack,
/area/shuttle/abandoned/engine)
"hE" = (
/obj/effect/decal/cleanable/blood/footprints,
/turf/open/floor/engine,
/area/shuttle/abandoned/medbay)
"hU" = (
/obj/structure/table/wood,
/obj/machinery/chem_dispenser/drinks/beer/fullupgrade,
/obj/machinery/light/directional/north,
/turf/open/floor/wood,
/area/shuttle/abandoned/bar)
"if" = (
/obj/effect/decal/cleanable/blood/footprints,
/turf/open/floor/engine,
/area/shuttle/abandoned/cargo)
"is" = (
/obj/item/plunger,
/obj/item/clothing/glasses/science,
/obj/item/storage/box/beakers/bluespace,
/obj/item/storage/box/beakers/variety,
/obj/structure/closet/secure_closet/chemical/heisenberg{
	req_access = null
	},
/turf/open/floor/engine,
/area/shuttle/abandoned/medbay)
"iQ" = (
/mob/living/simple_animal/hostile/pirate/melee/space,
/turf/open/floor/carpet/royalblack,
/area/shuttle/abandoned/engine)
"jr" = (
/obj/machinery/biogenerator,
/turf/open/floor/engine,
/area/shuttle/abandoned/medbay)
"jy" = (
/turf/open/floor/wood,
/area/shuttle/abandoned/bar)
"jG" = (
/obj/machinery/shower,
/obj/structure/curtain,
/obj/item/soap/homemade,
/turf/open/floor/oldshuttle,
/area/shuttle/abandoned/bar)
"jV" = (
/turf/closed/wall/mineral/titanium,
/area/shuttle/abandoned/cargo)
"kq" = (
/obj/machinery/chem_heater,
/turf/open/floor/engine,
/area/shuttle/abandoned/medbay)
"ku" = (
/turf/closed/wall/mineral/titanium/nodiagonal,
/area/shuttle/abandoned/crew)
"kM" = (
/obj/machinery/door/airlock/shuttle,
/obj/effect/decal/cleanable/dirt/dust,
/obj/docking_port/mobile{
	callTime = 250;
	can_move_docking_ports = 1;
	dir = 2;
	dwidth = 11;
	height = 17;
	launch_status = 0;
	movement_force = list("KNOCKDOWN" = 0, "THROW" = 0);
	name = "Salvage Ship";
	port_direction = 8;
	preferred_direction = 4;
	shuttle_id = "whiteship";
	width = 33
	},
/obj/structure/fans/tiny,
/turf/open/floor/engine,
/area/shuttle/abandoned/cargo)
"ls" = (
/mob/living/simple_animal/pet/cat/space,
/turf/open/floor/oldshuttle,
/area/shuttle/abandoned/bar)
"mD" = (
/obj/structure/closet/secure_closet/personal,
/obj/item/storage/belt/utility/full/engi,
/obj/item/storage/belt/medical,
/obj/item/construction/rcd/loaded,
/turf/open/floor/carpet/purple,
/area/shuttle/abandoned/crew)
"mG" = (
/obj/effect/decal/cleanable/blood/splatter,
/turf/open/floor/engine,
/area/shuttle/abandoned/medbay)
"mW" = (
/obj/machinery/light/floor,
/turf/open/floor/engine,
/area/shuttle/abandoned/cargo)
"nm" = (
/obj/structure/sink,
/obj/item/razor,
/turf/open/floor/oldshuttle,
/area/shuttle/abandoned/bar)
"oW" = (
/obj/effect/spawner/structure/window/reinforced/tinted,
/turf/open/floor/engine,
/area/shuttle/abandoned/medbay)
"pj" = (
/obj/structure/reagent_dispensers/watertank/high,
/turf/open/floor/engine,
/area/shuttle/abandoned/cargo)
"pG" = (
/obj/machinery/light/directional/north,
/turf/open/floor/engine,
/area/shuttle/abandoned/medbay)
"pY" = (
/obj/structure/closet/secure_closet/freezer/fridge,
/obj/machinery/light/directional/east,
/turf/open/floor/iron/cafeteria,
/area/shuttle/abandoned/bar)
"qx" = (
/obj/machinery/vending/boozeomat,
/turf/open/floor/wood,
/area/shuttle/abandoned/bar)
"rn" = (
/obj/structure/dresser,
/turf/open/floor/carpet/purple,
/area/shuttle/abandoned/cargo)
"rJ" = (
/turf/open/floor/engine,
/area/shuttle/abandoned/medbay)
"sA" = (
/turf/open/floor/iron/cafeteria,
/area/shuttle/abandoned/bar)
"uj" = (
/obj/structure/window/reinforced{
	dir = 1
	},
/obj/machinery/power/shuttle_engine/propulsion/burst,
/turf/open/floor/plating/airless,
/area/shuttle/abandoned/cargo)
"uY" = (
/obj/structure/closet/wardrobe,
/obj/item/clothing/under/suit/sl,
/obj/item/clothing/under/misc/assistantformal,
/obj/item/clothing/under/misc/bouncer,
/obj/item/clothing/under/misc/pj/red,
/obj/item/clothing/under/misc/pj/blue,
/turf/open/floor/carpet/purple,
/area/shuttle/abandoned/crew)
"vb" = (
/obj/structure/table/wood,
/obj/machinery/chem_dispenser/drinks/fullupgrade,
/turf/open/floor/wood,
/area/shuttle/abandoned/bar)
"vJ" = (
/obj/machinery/vending/hydronutrients,
/obj/machinery/light/directional/north,
/turf/open/floor/engine,
/area/shuttle/abandoned/cargo)
"wO" = (
/obj/machinery/vending/hydroseeds,
/turf/open/floor/engine,
/area/shuttle/abandoned/cargo)
"xr" = (
/obj/structure/window/reinforced{
	dir = 1
	},
/turf/open/floor/plating/airless,
/area/shuttle/abandoned/cargo)
"xM" = (
/obj/effect/spawner/structure/window/reinforced,
/turf/closed/wall,
/area/shuttle/abandoned/medbay)
"ym" = (
/obj/structure/bed,
/obj/item/bedsheet/dorms,
/turf/open/floor/carpet/purple,
/area/shuttle/abandoned/crew)
"yw" = (
/obj/machinery/chem_master,
/obj/machinery/light/floor,
/turf/open/floor/engine,
/area/shuttle/abandoned/medbay)
"yL" = (
/turf/open/floor/oldshuttle,
/area/shuttle/abandoned/bar)
"yN" = (
/turf/open/floor/carpet/royalblack,
/area/shuttle/abandoned/engine)
"yQ" = (
/obj/structure/closet/crate/bin,
/obj/item/reagent_containers/hypospray/medipen/pumpup,
/obj/machinery/light/directional/north,
/turf/open/floor/wood,
/area/shuttle/abandoned/bar)
"zj" = (
/obj/machinery/door/airlock/titanium/glass,
/turf/open/floor/engine,
/area/shuttle/abandoned/cargo)
"zx" = (
/obj/machinery/light/directional/west,
/turf/open/floor/carpet/royalblack,
/area/shuttle/abandoned/engine)
"zA" = (
/obj/machinery/chem_dispenser/fullupgrade,
/turf/open/floor/engine,
/area/shuttle/abandoned/medbay)
"Aj" = (
/obj/item/storage/box/syringes/variety,
/obj/item/storage/box/syringes,
/obj/item/storage/box/pillbottles,
/obj/structure/closet/secure_closet/chemical/heisenberg{
	req_access = null
	},
/turf/open/floor/engine,
/area/shuttle/abandoned/medbay)
"AN" = (
/obj/structure/table/reinforced,
/obj/machinery/reagentgrinder,
/turf/open/floor/engine,
/area/shuttle/abandoned/medbay)
"Br" = (
/obj/structure/table/wood,
/obj/machinery/microwave,
/turf/open/floor/iron/cafeteria,
/area/shuttle/abandoned/bar)
"Ca" = (
/turf/closed/wall/mineral/titanium,
/area/shuttle/abandoned/medbay)
"CC" = (
/obj/machinery/plumbing/grinder_chemical,
/turf/open/floor/engine,
/area/shuttle/abandoned/medbay)
"DB" = (
/turf/closed/wall/mineral/titanium/nodiagonal,
/area/shuttle/abandoned/bar)
"Eg" = (
/mob/living/simple_animal/hostile/pirate/melee/space,
/turf/open/floor/engine,
/area/shuttle/abandoned/cargo)
"Fc" = (
/obj/machinery/shower,
/turf/open/floor/oldshuttle,
/area/shuttle/abandoned/bar)
"FD" = (
/turf/closed/wall/mineral/titanium/interior,
/area/shuttle/abandoned/medbay)
"Gf" = (
/turf/closed/wall/mineral/titanium,
/area/shuttle/abandoned/crew)
"Gh" = (
/obj/machinery/light/directional/east,
/turf/open/floor/carpet/royalblack,
/area/shuttle/abandoned/engine)
"Gi" = (
/obj/machinery/door/airlock/alarmlock,
/turf/open/floor/oldshuttle,
/area/shuttle/abandoned/bar)
"Gp" = (
/obj/machinery/light/directional/south,
/turf/open/floor/engine,
/area/shuttle/abandoned/medbay)
"GQ" = (
/obj/structure/mirror,
/turf/closed/wall/mineral/titanium,
/area/shuttle/abandoned/medbay)
"Hu" = (
/obj/structure/closet/emcloset/anchored,
/turf/open/floor/engine,
/area/shuttle/abandoned/cargo)
"HV" = (
/obj/effect/spawner/structure/window/reinforced/tinted,
/turf/open/floor/engine,
/area/shuttle/abandoned/engine)
"Iw" = (
/obj/structure/toilet,
/turf/open/floor/oldshuttle,
/area/shuttle/abandoned/bar)
"Jl" = (
/obj/structure/closet/wardrobe,
/obj/item/clothing/shoes/workboots,
/obj/item/clothing/shoes/sandal,
/turf/open/floor/carpet/purple,
/area/shuttle/abandoned/crew)
"JD" = (
/turf/closed/wall/mineral/titanium/interior,
/area/shuttle/abandoned/bar)
"JK" = (
/obj/effect/decal/cleanable/blood/footprints{
	dir = 4
	},
/turf/open/floor/engine,
/area/shuttle/abandoned/medbay)
"KC" = (
/obj/effect/decal/cleanable/blood/footprints,
/obj/machinery/light/floor,
/turf/open/floor/engine,
/area/shuttle/abandoned/cargo)
"KJ" = (
/turf/closed/wall/mineral/titanium/nodiagonal,
/area/shuttle/abandoned/medbay)
"La" = (
/obj/machinery/hydroponics/constructable,
/turf/open/floor/engine,
/area/shuttle/abandoned/cargo)
"LP" = (
/turf/closed/wall/mineral/titanium/nodiagonal,
/area/shuttle/abandoned/cargo)
"Mi" = (
/obj/machinery/light/directional/east,
/turf/open/floor/carpet/purple,
/area/shuttle/abandoned/crew)
"MP" = (
/obj/machinery/rnd/production/protolathe/department/medical,
/turf/open/floor/engine,
/area/shuttle/abandoned/medbay)
"Nv" = (
/obj/machinery/plumbing/synthesizer,
/turf/open/floor/engine,
/area/shuttle/abandoned/medbay)
"Oj" = (
/obj/machinery/power/shuttle_engine/large,
/turf/open/floor/plating/airless,
/area/shuttle/abandoned/cargo)
"Oo" = (
/turf/template_noop,
/area/template_noop)
"Ov" = (
/obj/machinery/computer/shuttle,
/turf/open/floor/carpet/royalblack,
/area/shuttle/abandoned/engine)
"Pb" = (
/turf/open/floor/engine,
/area/shuttle/abandoned/cargo)
"Pc" = (
/obj/machinery/hydroponics/constructable,
/obj/machinery/light/directional/west,
/turf/open/floor/engine,
/area/shuttle/abandoned/cargo)
"Pr" = (
/obj/structure/table/reinforced,
/obj/item/pipe_dispenser,
/turf/open/floor/engine,
/area/shuttle/abandoned/medbay)
"Pw" = (
/obj/effect/decal/cleanable/blood/gibs/body,
/turf/open/floor/engine,
/area/shuttle/abandoned/medbay)
"PQ" = (
/obj/structure/table/reinforced,
/obj/item/stack/sheet/mineral/plasma,
/obj/item/stack/sheet/mineral/gold,
/obj/item/stack/sheet/mineral/silver,
/obj/item/storage/backpack/chemistry,
/turf/open/floor/engine,
/area/shuttle/abandoned/medbay)
"Rg" = (
/obj/structure/table/reinforced,
/obj/machinery/light/directional/south,
/turf/open/floor/engine,
/area/shuttle/abandoned/medbay)
"Rq" = (
/obj/machinery/door/airlock/public/glass,
/turf/open/floor/iron/cafeteria,
/area/shuttle/abandoned/bar)
"Rr" = (
/obj/structure/table/wood,
/obj/item/toy/cards/deck/tarot,
/obj/item/storage/box/donkpockets/donkpocketberry,
/turf/open/floor/wood,
/area/shuttle/abandoned/bar)
"RJ" = (
/obj/machinery/plumbing/liquid_pump,
/turf/open/floor/engine,
/area/shuttle/abandoned/medbay)
"Sg" = (
/obj/effect/spawner/structure/window/reinforced,
/turf/closed/wall,
/area/shuttle/abandoned/bar)
"Sh" = (
/obj/effect/spawner/structure/window,
/turf/open/floor/iron/cafeteria,
/area/shuttle/abandoned/bar)
"Sm" = (
/obj/machinery/light/directional/north,
/turf/open/floor/oldshuttle,
/area/shuttle/abandoned/bar)
"SK" = (
/obj/machinery/door/airlock/titanium,
/turf/open/floor/carpet/royalblack,
/area/shuttle/abandoned/bar)
"TF" = (
/obj/structure/table/reinforced,
/obj/item/construction/plumbing,
/obj/item/stack/ducts/fifty,
/obj/item/stack/ducts/fifty,
/obj/item/stack/ducts/fifty,
/turf/open/floor/engine,
/area/shuttle/abandoned/medbay)
"UI" = (
/obj/structure/chair/comfy/black,
/turf/open/floor/wood,
/area/shuttle/abandoned/bar)
"Vl" = (
/obj/machinery/light/directional/south,
/turf/open/floor/carpet/purple,
/area/shuttle/abandoned/crew)
"Vw" = (
/obj/structure/window/reinforced/shuttle,
/turf/closed/wall,
/area/shuttle/abandoned/medbay)
"Vx" = (
/obj/item/toy/cattoy,
/turf/open/floor/carpet/purple,
/area/shuttle/abandoned/crew)
"VD" = (
/obj/machinery/door/airlock/public/glass,
/obj/effect/decal/cleanable/blood/footprints,
/turf/open/floor/engine,
/area/shuttle/abandoned/cargo)
"Wq" = (
/obj/machinery/light/directional/south,
/turf/open/floor/engine,
/area/shuttle/abandoned/cargo)
"WR" = (
/obj/structure/window/reinforced/shuttle,
/turf/open/floor/iron/cafeteria,
/area/shuttle/abandoned/bar)
"WT" = (
/obj/effect/spawner/structure/window/reinforced/tinted,
/turf/open/floor/engine,
/area/shuttle/abandoned/cargo)
"Xw" = (
/obj/item/seeds/cannabis,
/obj/item/seeds/amanita,
/obj/structure/table/reinforced,
/obj/item/seeds/cannabis/rainbow,
/turf/open/floor/engine,
/area/shuttle/abandoned/cargo)
"YX" = (
/obj/machinery/light/floor,
/turf/open/floor/engine,
/area/shuttle/abandoned/medbay)
"Zh" = (
/obj/machinery/door/airlock/titanium/glass,
/turf/open/floor/engine,
/area/shuttle/abandoned/medbay)
"Zn" = (
/obj/effect/decal/cleanable/blood,
/turf/open/floor/engine,
/area/shuttle/abandoned/medbay)
"Zq" = (
/obj/effect/decal/cleanable/blood/gibs/down,
/turf/open/floor/engine,
/area/shuttle/abandoned/medbay)
"ZB" = (
/obj/structure/bed,
/obj/item/bedsheet/cosmos,
/obj/item/toy/plush/nukeplushie,
/turf/open/floor/carpet/purple,
/area/shuttle/abandoned/crew)

(1,1,1) = {"
Oo
Oo
Oo
Oo
Oo
Oo
Oo
Oo
Oo
Oo
Oo
Oo
Oo
jV
jV
jV
jV
jV
jV
jV
jV
jV
Oo
Oo
Oo
Oo
"}
(2,1,1) = {"
Oo
Oo
Oo
Oo
Oo
Oo
Oo
Oo
Oo
Oo
Oo
Oo
jV
LP
La
La
Pb
Pc
La
Pb
pj
jV
Oo
Oo
Oo
Oo
"}
(3,1,1) = {"
Oo
Oo
Oo
Oo
Oo
Oo
Oo
Oo
Oo
Oo
Oo
jV
LP
wO
Pb
Pb
Pb
Pb
Eg
Pb
Xw
jV
Oo
Oo
Oo
Oo
"}
(4,1,1) = {"
Oo
Oo
Oo
Oo
Oo
Oo
Oo
Oo
Oo
Oo
jV
LP
vJ
Pb
Pb
Pb
Pb
Pb
Pb
Wq
LP
jV
Oo
Oo
Oo
Oo
"}
(5,1,1) = {"
Oo
Oo
Oo
Oo
Oo
Oo
Oo
Oo
Oo
jV
LP
bF
Pb
Pb
Pb
Pb
Pb
Pb
cy
LP
jV
Oo
Oo
Oo
Oo
Oo
"}
(6,1,1) = {"
Oo
Oo
Oo
Oo
Oo
Oo
Oo
Oo
Ca
KJ
jr
rJ
rJ
rJ
rJ
rJ
rJ
gw
KJ
jV
Oo
Oo
Oo
Oo
Oo
Oo
"}
(7,1,1) = {"
Oo
Oo
Oo
Oo
Oo
Oo
fk
fk
KJ
oW
oW
oW
oW
oW
Zh
oW
oW
oW
oW
jV
jV
Oo
Oo
Oo
Oo
Oo
"}
(8,1,1) = {"
Oo
Oo
Oo
Oo
Oo
Oo
fk
yQ
dh
is
rJ
rJ
rJ
rJ
rJ
rJ
kq
rJ
zA
jV
uj
em
Oo
Oo
Oo
Oo
"}
(9,1,1) = {"
Oo
Oo
Oo
Oo
Oo
fk
DB
jy
xM
AN
rJ
rJ
rJ
rJ
rJ
rJ
dh
rJ
Rg
jV
xr
Oj
Oo
Oo
Oo
Oo
"}
(10,1,1) = {"
Oo
Oo
Oo
Oo
fk
LP
jy
jy
xM
PQ
rJ
YX
rJ
rJ
rJ
rJ
yw
rJ
gY
jV
xr
em
Oo
Oo
Oo
Oo
"}
(11,1,1) = {"
Oo
Oo
bL
bL
DB
hU
jy
UI
xM
rJ
rJ
mG
rJ
rJ
rJ
rJ
rJ
rJ
rJ
jV
uj
em
Oo
Oo
Oo
Oo
"}
(12,1,1) = {"
Oo
Oo
bL
zx
Sg
vb
jy
Rr
xM
rJ
Pw
rJ
rJ
rJ
rJ
rJ
rJ
rJ
rJ
jV
jV
jV
jV
Oo
Oo
Oo
"}
(13,1,1) = {"
bL
bL
bL
yN
Sg
qx
jy
UI
xM
rJ
JK
rJ
ct
rJ
rJ
rJ
rJ
rJ
rJ
jV
Hu
Pb
jV
jV
jV
jV
"}
(14,1,1) = {"
HV
hd
yN
yN
Sg
Sh
Rq
Sh
xM
rJ
JK
rJ
rJ
RJ
rJ
rJ
rJ
rJ
rJ
jV
Pb
Pb
Pb
Pb
Pb
jV
"}
(15,1,1) = {"
HV
Ov
dX
yN
SK
sA
sA
sA
Zh
rJ
JK
rJ
rJ
rJ
rJ
Zn
hE
hE
hE
VD
KC
if
mW
Pb
mW
kM
"}
(16,1,1) = {"
HV
ar
yN
iQ
WR
sA
sA
sA
Vw
rJ
rJ
Nv
rJ
rJ
rJ
rJ
rJ
rJ
rJ
jV
Pb
Pb
Pb
Pb
Pb
jV
"}
(17,1,1) = {"
bL
bL
bL
yN
WR
Br
sA
pY
Vw
rJ
rJ
rJ
rJ
rJ
rJ
Zq
rJ
rJ
rJ
jV
Hu
Pb
jV
jV
jV
jV
"}
(18,1,1) = {"
Oo
Oo
bL
Gh
JD
JD
Gi
JD
FD
pG
rJ
bU
rJ
rJ
rJ
rJ
rJ
rJ
rJ
jV
jV
jV
jV
Oo
Oo
Oo
"}
(19,1,1) = {"
Oo
Oo
bL
bL
DB
Iw
ls
nm
GQ
rJ
rJ
rJ
rJ
rJ
rJ
CC
rJ
rJ
rJ
jV
uj
em
Oo
Oo
Oo
Oo
"}
(20,1,1) = {"
Oo
Oo
Oo
Oo
fk
DB
Sm
yL
FD
TF
rJ
YX
ct
rJ
rJ
rJ
YX
rJ
rJ
jV
xr
Oj
Oo
Oo
Oo
Oo
"}
(21,1,1) = {"
Oo
Oo
Oo
Oo
Oo
fk
DB
jG
FD
Pr
rJ
rJ
rJ
rJ
rJ
rJ
rJ
rJ
Gp
jV
xr
em
Oo
Oo
Oo
Oo
"}
(22,1,1) = {"
Oo
Oo
Oo
Oo
Oo
Oo
fk
Fc
FD
Aj
rJ
rJ
rJ
rJ
rJ
rJ
rJ
rJ
MP
jV
uj
em
Oo
Oo
Oo
Oo
"}
(23,1,1) = {"
Oo
Oo
Oo
Oo
Oo
Oo
fk
jV
LP
WT
WT
WT
WT
WT
zj
WT
WT
WT
WT
jV
jV
Oo
Oo
Oo
Oo
Oo
"}
(24,1,1) = {"
Oo
Oo
Oo
Oo
Oo
Oo
Oo
Oo
jV
LP
ax
cL
Vx
cL
cL
Jl
uY
ey
ku
Gf
Oo
Oo
Oo
Oo
Oo
Oo
"}
(25,1,1) = {"
Oo
Oo
Oo
Oo
Oo
Oo
Oo
Oo
Oo
jV
ku
cL
cL
cL
cL
cL
cL
cL
rn
ku
Gf
Oo
Oo
Oo
Oo
Oo
"}
(26,1,1) = {"
Oo
Oo
Oo
Oo
Oo
Oo
Oo
Oo
Oo
Oo
Gf
ku
bQ
cL
cL
cL
cL
cL
cL
Vl
ku
Gf
Oo
Oo
Oo
Oo
"}
(27,1,1) = {"
Oo
Oo
Oo
Oo
Oo
Oo
Oo
Oo
Oo
Oo
Oo
Gf
ku
cL
cL
cL
cL
cL
cL
cL
cL
Gf
Oo
Oo
Oo
Oo
"}
(28,1,1) = {"
Oo
Oo
Oo
Oo
Oo
Oo
Oo
Oo
Oo
Oo
Oo
Oo
Gf
ku
ym
cL
ZB
Mi
aE
cL
mD
Gf
Oo
Oo
Oo
Oo
"}
(29,1,1) = {"
Oo
Oo
Oo
Oo
Oo
Oo
Oo
Oo
Oo
Oo
Oo
Oo
Oo
Gf
Gf
Gf
Gf
Gf
Gf
Gf
Gf
Gf
Oo
Oo
Oo
Oo
"}
