//MAP CONVERTED BY dmm2tgm.py THIS HEADER COMMENT PREVENTS RECONVERSION, DO NOT REMOVE
"ar" = (
/obj/structure/table/wood/fancy/black,
/obj/machinery/recharger,
/turf/open/floor/carpet/royalblack,
/area/shuttle/abandoned/engine)
"aw" = (
/obj/machinery/rnd/production/protolathe/department/medical,
/turf/open/floor/iron/smooth,
/area/shuttle/abandoned/medbay)
"ax" = (
/obj/structure/window/reinforced/shuttle,
/obj/item/food/pizza/meat,
/turf/open/space/basic,
/area/shuttle/abandoned/engine)
"aE" = (
/obj/structure/cable,
/turf/open/floor/iron/smooth,
/area/shuttle/abandoned/crew)
"bF" = (
/obj/machinery/vending/hydroseeds,
/turf/open/floor/iron/smooth,
/area/shuttle/abandoned/cargo)
"bL" = (
/turf/closed/wall/mineral/titanium,
/area/shuttle/abandoned/engine)
"bQ" = (
/obj/machinery/power/port_gen/pacman{
	anchored = 1
	},
/turf/open/floor/engine,
/area/shuttle/abandoned/crew)
"bU" = (
/obj/item/pizzabox,
/turf/template_noop,
/area/template_noop)
"ct" = (
/obj/structure/cable,
/turf/open/floor/engine,
/area/shuttle/abandoned/medbay)
"cy" = (
/obj/structure/cable,
/turf/open/floor/carpet/royalblack,
/area/shuttle/abandoned/engine)
"cC" = (
/obj/effect/spawner/structure/window/reinforced/tinted,
/turf/open/floor/iron/smooth,
/area/shuttle/abandoned/medbay)
"cL" = (
/turf/open/floor/engine,
/area/shuttle/abandoned/crew)
"dI" = (
/obj/effect/decal/cleanable/blood/footprints{
	dir = 8
	},
/obj/structure/cable,
/turf/open/floor/iron/dark,
/area/shuttle/abandoned/medbay)
"dX" = (
/obj/structure/chair/comfy/shuttle{
	dir = 1
	},
/obj/structure/cable,
/turf/open/floor/carpet/royalblack,
/area/shuttle/abandoned/engine)
"em" = (
/obj/machinery/airalarm/all_access{
	dir = 1;
	pixel_y = 24
	},
/turf/open/floor/wood,
/area/shuttle/abandoned/engine)
"ey" = (
/turf/open/floor/wood,
/area/shuttle/abandoned/engine)
"eN" = (
/obj/machinery/door/airlock/public/glass,
/obj/structure/cable,
/turf/open/floor/iron/dark,
/area/shuttle/abandoned/medbay)
"fh" = (
/obj/machinery/door/airlock/titanium/glass,
/obj/structure/cable,
/turf/open/floor/iron/dark,
/area/shuttle/abandoned/medbay)
"fk" = (
/turf/closed/wall/mineral/titanium,
/area/shuttle/abandoned/bar)
"fy" = (
/obj/machinery/chem_dispenser/fullupgrade,
/turf/open/floor/iron/smooth,
/area/shuttle/abandoned/medbay)
"gw" = (
/obj/machinery/smartfridge/drying_rack,
/obj/effect/turf_decal{
	dir = 4
	},
/turf/open/floor/iron/smooth,
/area/shuttle/abandoned/medbay)
"gT" = (
/obj/structure/closet/secure_closet/personal,
/obj/item/storage/belt/utility/full/engi,
/obj/item/construction/rcd/loaded,
/turf/open/floor/iron/smooth,
/area/shuttle/abandoned/medbay)
"gY" = (
/obj/structure/cable,
/turf/open/floor/iron/cafeteria,
/area/shuttle/abandoned/bar)
"hd" = (
/obj/structure/table/wood/fancy/black,
/obj/item/pai_card,
/turf/open/floor/carpet/royalblack,
/area/shuttle/abandoned/engine)
"hU" = (
/obj/structure/table/wood,
/obj/machinery/chem_dispenser/drinks/beer/fullupgrade,
/obj/machinery/light/directional/north,
/turf/open/floor/wood,
/area/shuttle/abandoned/bar)
"if" = (
/obj/effect/decal/cleanable/blood/footprints,
/obj/machinery/light/floor,
/obj/structure/cable,
/turf/open/floor/iron/dark,
/area/shuttle/abandoned/cargo)
"is" = (
/obj/item/plunger,
/obj/item/clothing/glasses/science,
/obj/item/storage/box/beakers/bluespace,
/obj/item/storage/box/beakers/variety,
/obj/structure/closet/secure_closet/chemical/heisenberg{
	req_access = null
	},
/turf/open/floor/engine,
/area/shuttle/abandoned/medbay)
"it" = (
/obj/structure/bed{
	dir = 4
	},
/obj/item/bedsheet/random{
	dir = 4
	},
/turf/open/floor/iron/smooth,
/area/shuttle/abandoned/crew)
"iQ" = (
/mob/living/simple_animal/hostile/pirate/melee/space,
/turf/open/floor/carpet/royalblack,
/area/shuttle/abandoned/engine)
"jr" = (
/obj/machinery/biogenerator,
/turf/open/floor/iron/smooth,
/area/shuttle/abandoned/medbay)
"jy" = (
/turf/open/floor/wood,
/area/shuttle/abandoned/bar)
"jG" = (
/obj/machinery/shower,
/obj/structure/curtain,
/obj/item/soap/homemade,
/turf/open/floor/oldshuttle,
/area/shuttle/abandoned/bar)
"jV" = (
/turf/closed/wall/mineral/titanium,
/area/shuttle/abandoned/cargo)
"kp" = (
/obj/machinery/airalarm/all_access{
	dir = 1;
	pixel_y = 24
	},
/obj/structure/cable,
/turf/open/floor/wood,
/area/shuttle/abandoned/bar)
"kq" = (
/obj/machinery/light/floor,
/obj/structure/cable,
/turf/open/floor/iron/dark,
/area/shuttle/abandoned/medbay)
"ku" = (
/turf/closed/wall/mineral/titanium/nodiagonal,
/area/shuttle/abandoned/crew)
"kL" = (
/obj/structure/fermenting_barrel,
/obj/effect/decal/cleanable/dirt,
/turf/open/floor/iron/smooth,
/area/shuttle/abandoned/cargo)
"kM" = (
/obj/structure/cable,
/turf/open/floor/wood,
/area/shuttle/abandoned/bar)
"ls" = (
/obj/effect/decal/cleanable/blood/footprints{
	dir = 1
	},
/obj/structure/cable,
/turf/open/floor/oldshuttle,
/area/shuttle/abandoned/bar)
"lY" = (
/obj/machinery/light/directional/south,
/obj/structure/dresser,
/turf/open/floor/iron/smooth,
/area/shuttle/abandoned/crew)
"mD" = (
/obj/structure/closet/crate/trashcart/laundry,
/turf/open/floor/iron/smooth,
/area/shuttle/abandoned/crew)
"mG" = (
/obj/effect/decal/cleanable/food/salt,
/obj/structure/cable,
/turf/open/floor/iron/cafeteria,
/area/shuttle/abandoned/bar)
"mW" = (
/obj/machinery/door/airlock/shuttle,
/obj/effect/decal/cleanable/dirt/dust,
/obj/docking_port/mobile{
	callTime = 250;
	can_move_docking_ports = 1;
	dir = 2;
	dwidth = 11;
	height = 17;
	launch_status = 0;
	movement_force = list("KNOCKDOWN" = 0, "THROW" = 0);
	name = "Salvage Ship";
	port_direction = 8;
	preferred_direction = 4;
	shuttle_id = "whiteship";
	width = 33
	},
/obj/structure/fans/tiny,
/turf/open/floor/engine,
/area/shuttle/abandoned/cargo)
"mY" = (
/obj/structure/closet/emcloset/anchored,
/obj/effect/turf_decal/box/white/corners{
	dir = 1
	},
/turf/open/floor/iron/smooth,
/area/shuttle/abandoned/cargo)
"nm" = (
/obj/item/razor,
/obj/item/knife/combat/survival,
/obj/effect/decal/cleanable/blood,
/turf/open/floor/oldshuttle,
/area/shuttle/abandoned/bar)
"nt" = (
/mob/living/simple_animal/pet/cat/space,
/turf/open/floor/iron/smooth,
/area/shuttle/abandoned/crew)
"oW" = (
/obj/effect/spawner/structure/window/reinforced/tinted,
/turf/open/floor/engine,
/area/shuttle/abandoned/medbay)
"pp" = (
/obj/effect/turf_decal/box/white/corners{
	dir = 4
	},
/turf/open/floor/iron/smooth,
/area/shuttle/abandoned/cargo)
"pA" = (
/obj/effect/turf_decal{
	dir = 4
	},
/obj/structure/cable,
/turf/open/floor/iron/dark,
/area/shuttle/abandoned/medbay)
"pG" = (
/obj/machinery/light/directional/north,
/turf/open/floor/engine,
/area/shuttle/abandoned/medbay)
"pY" = (
/obj/structure/closet/secure_closet/freezer/fridge,
/obj/machinery/light/directional/east,
/turf/open/floor/iron/cafeteria,
/area/shuttle/abandoned/bar)
"qs" = (
/obj/structure/bed{
	dir = 8
	},
/obj/item/bedsheet/cosmos{
	dir = 8
	},
/obj/item/toy/plush/nukeplushie,
/turf/open/floor/iron/smooth,
/area/shuttle/abandoned/crew)
"qw" = (
/obj/structure/table/reinforced,
/obj/item/stack/sheet/mineral/plasma,
/obj/item/stack/sheet/mineral/gold,
/obj/item/stack/sheet/mineral/silver,
/obj/item/storage/backpack/chemistry,
/turf/open/floor/iron/smooth,
/area/shuttle/abandoned/medbay)
"qx" = (
/obj/machinery/vending/boozeomat,
/turf/open/floor/wood,
/area/shuttle/abandoned/bar)
"rn" = (
/obj/effect/decal/cleanable/ants,
/turf/open/floor/wood,
/area/shuttle/abandoned/bar)
"rJ" = (
/turf/open/floor/engine,
/area/shuttle/abandoned/medbay)
"rU" = (
/obj/machinery/light/floor,
/obj/structure/cable,
/turf/open/floor/iron/dark,
/area/shuttle/abandoned/crew)
"sh" = (
/obj/machinery/chem_master,
/obj/machinery/light/floor,
/turf/open/floor/iron/smooth,
/area/shuttle/abandoned/medbay)
"sA" = (
/turf/open/floor/iron/cafeteria,
/area/shuttle/abandoned/bar)
"sO" = (
/turf/open/floor/iron/smooth,
/area/shuttle/abandoned/medbay)
"sQ" = (
/obj/structure/closet/wardrobe,
/obj/item/clothing/under/misc/pj/red,
/obj/item/clothing/under/misc/pj/blue,
/turf/open/floor/iron/smooth,
/area/shuttle/abandoned/crew)
"tt" = (
/obj/effect/turf_decal{
	dir = 1
	},
/turf/open/floor/iron/smooth,
/area/shuttle/abandoned/medbay)
"uj" = (
/obj/machinery/power/shuttle_engine/large,
/turf/open/floor/plating/airless,
/area/shuttle/abandoned/cargo)
"uA" = (
/obj/machinery/vending/cola/sodie,
/turf/open/floor/iron/smooth,
/area/shuttle/abandoned/cargo)
"uY" = (
/obj/machinery/door/airlock/titanium/glass,
/obj/structure/cable,
/turf/open/floor/iron/dark,
/area/shuttle/abandoned/crew)
"vb" = (
/obj/structure/table/wood,
/obj/machinery/chem_dispenser/drinks/fullupgrade,
/turf/open/floor/wood,
/area/shuttle/abandoned/bar)
"vS" = (
/obj/machinery/power/apc/auto_name/directional/south,
/obj/structure/cable,
/turf/open/floor/engine,
/area/shuttle/abandoned/crew)
"wk" = (
/obj/effect/decal/cleanable/blood/gibs/down,
/obj/structure/cable,
/turf/open/floor/iron/dark,
/area/shuttle/abandoned/medbay)
"wO" = (
/obj/machinery/vending/hydronutrients,
/obj/machinery/light/directional/north,
/turf/open/floor/iron/smooth,
/area/shuttle/abandoned/cargo)
"wV" = (
/obj/item/seeds/cannabis,
/obj/item/seeds/amanita,
/obj/structure/table/reinforced,
/obj/item/seeds/cannabis/rainbow,
/obj/item/reagent_containers/cup/bucket,
/turf/open/floor/iron/smooth,
/area/shuttle/abandoned/cargo)
"xr" = (
/turf/open/floor/plating/airless,
/area/shuttle/abandoned/cargo)
"xz" = (
/obj/effect/decal/cleanable/dirt,
/turf/open/floor/iron/smooth,
/area/shuttle/abandoned/medbay)
"xL" = (
/obj/effect/turf_decal/bot_white,
/obj/machinery/plumbing/pill_press,
/turf/open/floor/engine,
/area/shuttle/abandoned/medbay)
"xM" = (
/obj/structure/sign/poster/contraband/lusty_xenomorph,
/turf/closed/wall/mineral/titanium,
/area/shuttle/abandoned/medbay)
"ym" = (
/obj/effect/turf_decal,
/obj/structure/cable,
/turf/open/floor/iron/cafeteria,
/area/shuttle/abandoned/bar)
"yw" = (
/obj/structure/cable,
/turf/open/floor/iron/dark,
/area/shuttle/abandoned/medbay)
"yL" = (
/obj/item/organ/external/tail/lizard,
/obj/effect/decal/cleanable/blood,
/turf/open/floor/oldshuttle,
/area/shuttle/abandoned/bar)
"yN" = (
/turf/open/floor/carpet/royalblack,
/area/shuttle/abandoned/engine)
"yQ" = (
/obj/structure/closet/crate/bin,
/obj/item/reagent_containers/hypospray/medipen/pumpup,
/obj/machinery/light/directional/north,
/turf/open/floor/wood,
/area/shuttle/abandoned/bar)
"zj" = (
/obj/structure/window/reinforced/shuttle,
/turf/open/space/basic,
/area/shuttle/abandoned/medbay)
"zw" = (
/obj/effect/turf_decal{
	dir = 1
	},
/obj/structure/table/reinforced,
/obj/item/clothing/glasses/sunglasses/chemical,
/obj/item/clothing/glasses/sunglasses/chemical,
/obj/structure/desk_bell,
/turf/open/floor/iron/smooth,
/area/shuttle/abandoned/medbay)
"zx" = (
/obj/machinery/light/directional/west,
/turf/open/floor/wood,
/area/shuttle/abandoned/engine)
"zA" = (
/obj/effect/turf_decal/box/white,
/obj/machinery/plumbing/synthesizer,
/turf/open/floor/engine,
/area/shuttle/abandoned/medbay)
"zU" = (
/obj/machinery/power/smes/engineering{
	charge = 1e+006
	},
/obj/structure/cable,
/turf/open/floor/engine,
/area/shuttle/abandoned/crew)
"Ac" = (
/obj/effect/turf_decal/box/white/corners{
	dir = 8
	},
/turf/open/floor/iron/smooth,
/area/shuttle/abandoned/cargo)
"Aj" = (
/obj/item/storage/box/syringes/variety,
/obj/item/storage/box/syringes,
/obj/item/storage/box/pillbottles,
/obj/structure/closet/secure_closet/chemical/heisenberg{
	req_access = null
	},
/obj/item/stack/ore/bluespace_crystal/artificial,
/turf/open/floor/engine,
/area/shuttle/abandoned/medbay)
"AN" = (
/obj/effect/decal/cleanable/blood/footprints{
	dir = 4
	},
/obj/effect/turf_decal/box/white,
/obj/structure/cable,
/turf/open/floor/engine,
/area/shuttle/abandoned/medbay)
"Br" = (
/obj/structure/table/wood,
/obj/machinery/microwave,
/turf/open/floor/iron/cafeteria,
/area/shuttle/abandoned/bar)
"BZ" = (
/obj/effect/turf_decal/box/white/corners{
	dir = 1
	},
/turf/open/floor/iron/smooth,
/area/shuttle/abandoned/cargo)
"Ca" = (
/turf/closed/wall/mineral/titanium,
/area/shuttle/abandoned/medbay)
"CC" = (
/obj/machinery/airalarm/all_access{
	dir = 1;
	pixel_y = 24
	},
/turf/open/floor/iron/smooth,
/area/shuttle/abandoned/medbay)
"Di" = (
/turf/open/floor/iron/smooth,
/area/shuttle/abandoned/crew)
"DA" = (
/obj/structure/closet/emcloset/anchored,
/obj/effect/turf_decal/box/white/corners{
	dir = 4
	},
/turf/open/floor/iron/smooth,
/area/shuttle/abandoned/cargo)
"DB" = (
/turf/closed/wall/mineral/titanium/nodiagonal,
/area/shuttle/abandoned/bar)
"Es" = (
/obj/effect/spawner/structure/window/reinforced/tinted,
/turf/open/floor/iron/dark,
/area/shuttle/abandoned/medbay)
"EV" = (
/obj/machinery/airalarm/all_access{
	dir = 4;
	pixel_x = 24
	},
/obj/structure/cable,
/turf/open/floor/iron/smooth,
/area/shuttle/abandoned/crew)
"Fc" = (
/obj/machinery/shower,
/turf/open/floor/oldshuttle,
/area/shuttle/abandoned/bar)
"FD" = (
/turf/closed/wall/mineral/titanium/interior,
/area/shuttle/abandoned/medbay)
"Ga" = (
/obj/effect/decal/cleanable/dirt,
/turf/open/floor/iron/smooth,
/area/shuttle/abandoned/cargo)
"Gf" = (
/turf/closed/wall/mineral/titanium,
/area/shuttle/abandoned/crew)
"Gh" = (
/obj/machinery/light/directional/east,
/turf/open/floor/wood,
/area/shuttle/abandoned/engine)
"Gi" = (
/obj/machinery/door/airlock/alarmlock,
/obj/structure/cable,
/turf/open/floor/oldshuttle,
/area/shuttle/abandoned/bar)
"Gp" = (
/obj/effect/turf_decal/box/white,
/turf/open/floor/engine,
/area/shuttle/abandoned/medbay)
"GQ" = (
/obj/structure/mirror,
/turf/closed/wall/mineral/titanium,
/area/shuttle/abandoned/medbay)
"Hu" = (
/turf/open/floor/iron/smooth,
/area/shuttle/abandoned/cargo)
"HV" = (
/obj/structure/window/reinforced/shuttle,
/turf/open/space/basic,
/area/shuttle/abandoned/engine)
"Ik" = (
/obj/structure/table/wood,
/obj/item/gun/ballistic/rifle/boltaction/pipegun,
/obj/effect/turf_decal/box/white/corners,
/turf/open/floor/iron/smooth,
/area/shuttle/abandoned/cargo)
"Iw" = (
/obj/structure/toilet,
/turf/open/floor/oldshuttle,
/area/shuttle/abandoned/bar)
"Jl" = (
/turf/open/floor/engine,
/area/shuttle/abandoned/cargo)
"JB" = (
/obj/machinery/door/airlock/public/glass,
/obj/effect/decal/cleanable/blood/footprints,
/obj/structure/cable,
/turf/open/floor/engine,
/area/shuttle/abandoned/medbay)
"JD" = (
/turf/closed/wall/mineral/titanium/interior,
/area/shuttle/abandoned/bar)
"JK" = (
/obj/effect/decal/cleanable/blood/footprints{
	dir = 4
	},
/obj/effect/turf_decal/box/white,
/turf/open/floor/engine,
/area/shuttle/abandoned/medbay)
"Kw" = (
/obj/effect/turf_decal/box/white/corners,
/turf/open/floor/iron/smooth,
/area/shuttle/abandoned/cargo)
"KC" = (
/obj/structure/cable,
/turf/open/floor/iron/dark,
/area/shuttle/abandoned/cargo)
"KJ" = (
/turf/closed/wall/mineral/titanium/nodiagonal,
/area/shuttle/abandoned/medbay)
"La" = (
/obj/machinery/hydroponics/constructable,
/obj/structure/cable,
/turf/open/floor/iron/smooth,
/area/shuttle/abandoned/cargo)
"LP" = (
/turf/closed/wall/mineral/titanium/nodiagonal,
/area/shuttle/abandoned/cargo)
"Mi" = (
/obj/structure/bed{
	dir = 8
	},
/obj/item/bedsheet/random{
	dir = 8
	},
/obj/structure/cable,
/turf/open/floor/iron/smooth,
/area/shuttle/abandoned/crew)
"MP" = (
/mob/living/simple_animal/hostile/pirate/melee/space,
/obj/effect/turf_decal{
	dir = 4
	},
/turf/open/floor/iron/smooth,
/area/shuttle/abandoned/medbay)
"Nv" = (
/obj/machinery/computer/monitor{
	dir = 8
	},
/obj/structure/cable,
/turf/open/floor/engine,
/area/shuttle/abandoned/crew)
"Oe" = (
/obj/machinery/power/shuttle_engine/propulsion/burst,
/turf/open/floor/plating/airless,
/area/shuttle/abandoned/cargo)
"Oj" = (
/obj/effect/turf_decal{
	dir = 4
	},
/obj/structure/cable,
/turf/open/floor/iron/smooth,
/area/shuttle/abandoned/medbay)
"Oo" = (
/turf/template_noop,
/area/template_noop)
"Ov" = (
/obj/machinery/computer/shuttle,
/obj/structure/cable,
/turf/open/floor/carpet/royalblack,
/area/shuttle/abandoned/engine)
"OO" = (
/obj/machinery/light/directional/south,
/turf/open/floor/iron/smooth,
/area/shuttle/abandoned/cargo)
"Pb" = (
/obj/structure/cable,
/turf/open/floor/iron/smooth,
/area/shuttle/abandoned/cargo)
"Pc" = (
/obj/machinery/hydroponics/constructable,
/obj/machinery/light/directional/west,
/obj/structure/cable,
/turf/open/floor/iron/smooth,
/area/shuttle/abandoned/cargo)
"Pr" = (
/obj/structure/table/reinforced,
/obj/item/pipe_dispenser,
/turf/open/floor/engine,
/area/shuttle/abandoned/medbay)
"Pw" = (
/obj/effect/decal/cleanable/blood/gibs/body,
/obj/effect/turf_decal/box/white,
/turf/open/floor/engine,
/area/shuttle/abandoned/medbay)
"PQ" = (
/obj/machinery/airalarm/all_access{
	dir = 1;
	pixel_y = 24
	},
/turf/open/floor/engine,
/area/shuttle/abandoned/medbay)
"Qo" = (
/mob/living/simple_animal/hostile/pirate/melee/space,
/obj/structure/cable,
/turf/open/floor/iron/dark,
/area/shuttle/abandoned/medbay)
"Rg" = (
/obj/effect/decal/cleanable/blood/gibs/torso,
/obj/structure/cable,
/turf/open/floor/engine,
/area/shuttle/abandoned/medbay)
"Rq" = (
/obj/machinery/door/airlock/public/glass,
/obj/structure/cable,
/turf/open/floor/iron/cafeteria,
/area/shuttle/abandoned/bar)
"Rr" = (
/obj/structure/table/wood,
/obj/item/toy/cards/deck/tarot,
/obj/item/storage/box/donkpockets/donkpocketberry,
/turf/open/floor/wood,
/area/shuttle/abandoned/bar)
"RJ" = (
/obj/effect/turf_decal/bot_white/left,
/obj/machinery/plumbing/reaction_chamber/chem,
/obj/structure/cable,
/turf/open/floor/engine,
/area/shuttle/abandoned/medbay)
"Sg" = (
/obj/effect/spawner/structure/window/reinforced/tinted,
/turf/open/floor/wood,
/area/shuttle/abandoned/bar)
"Sh" = (
/obj/effect/turf_decal/bot_white/left,
/obj/structure/cable,
/turf/open/floor/engine,
/area/shuttle/abandoned/medbay)
"Sm" = (
/obj/machinery/light/directional/north,
/obj/structure/sink,
/obj/structure/cable,
/turf/open/floor/oldshuttle,
/area/shuttle/abandoned/bar)
"SG" = (
/obj/structure/sign/poster/contraband/smoke,
/turf/closed/wall/mineral/titanium/nodiagonal,
/area/shuttle/abandoned/cargo)
"SJ" = (
/obj/structure/table/wood,
/obj/item/storage/medkit,
/obj/item/ammo_box/magazine/internal/boltaction/pipegun,
/obj/effect/turf_decal/box/white/corners{
	dir = 8
	},
/turf/open/floor/iron/smooth,
/area/shuttle/abandoned/cargo)
"SK" = (
/obj/machinery/door/airlock/titanium,
/obj/structure/cable,
/turf/open/floor/carpet/royalblack,
/area/shuttle/abandoned/bar)
"Tb" = (
/obj/effect/turf_decal/bot_white,
/obj/machinery/plumbing/tank,
/turf/open/floor/engine,
/area/shuttle/abandoned/medbay)
"TD" = (
/obj/effect/turf_decal{
	dir = 4
	},
/turf/open/floor/iron/smooth,
/area/shuttle/abandoned/medbay)
"TF" = (
/obj/structure/table/reinforced,
/obj/item/construction/plumbing,
/obj/item/stack/ducts/fifty,
/obj/item/stack/ducts/fifty,
/obj/item/stack/ducts/fifty,
/turf/open/floor/engine,
/area/shuttle/abandoned/medbay)
"TZ" = (
/obj/structure/fermenting_barrel,
/obj/effect/turf_decal{
	dir = 4
	},
/turf/open/floor/iron/smooth,
/area/shuttle/abandoned/medbay)
"Uo" = (
/obj/structure/table/reinforced,
/obj/machinery/reagentgrinder,
/obj/item/paper/fluff/stations/soap,
/turf/open/floor/iron/smooth,
/area/shuttle/abandoned/medbay)
"UI" = (
/obj/structure/chair/comfy/black,
/turf/open/floor/wood,
/area/shuttle/abandoned/bar)
"UV" = (
/obj/machinery/chem_heater,
/turf/open/floor/iron/smooth,
/area/shuttle/abandoned/medbay)
"Vl" = (
/obj/structure/cable,
/turf/open/floor/engine,
/area/shuttle/abandoned/cargo)
"Vw" = (
/obj/structure/window/reinforced/shuttle,
/turf/open/floor/engine,
/area/shuttle/abandoned/medbay)
"Vx" = (
/obj/machinery/door/airlock/engineering{
	name = "Engineering"
	},
/obj/structure/cable,
/turf/open/floor/engine,
/area/shuttle/abandoned/crew)
"VD" = (
/obj/machinery/light/floor,
/obj/structure/cable,
/turf/open/floor/iron/dark,
/area/shuttle/abandoned/cargo)
"Wq" = (
/obj/structure/cable,
/turf/open/floor/engine,
/area/shuttle/abandoned/crew)
"WI" = (
/obj/effect/turf_decal/bot_white/left,
/turf/open/floor/engine,
/area/shuttle/abandoned/medbay)
"WR" = (
/obj/structure/window/reinforced/shuttle,
/turf/open/floor/iron/cafeteria,
/area/shuttle/abandoned/bar)
"WT" = (
/obj/item/wheelchair,
/turf/open/floor/engine,
/area/shuttle/abandoned/cargo)
"Xg" = (
/obj/machinery/airalarm/all_access{
	dir = 8;
	pixel_x = -24
	},
/obj/effect/decal/cleanable/dirt,
/turf/open/floor/iron/smooth,
/area/shuttle/abandoned/cargo)
"Xw" = (
/obj/structure/reagent_dispensers/watertank/high,
/turf/open/floor/iron/smooth,
/area/shuttle/abandoned/cargo)
"YV" = (
/obj/structure/table/reinforced,
/obj/item/storage/toolbox/emergency,
/obj/machinery/cell_charger,
/turf/open/floor/iron/smooth,
/area/shuttle/abandoned/medbay)
"YX" = (
/mob/living/simple_animal/hostile/pirate/ranged/space,
/turf/open/floor/engine,
/area/shuttle/abandoned/medbay)
"Zh" = (
/obj/machinery/door/airlock/titanium/glass,
/obj/structure/cable,
/turf/open/floor/engine,
/area/shuttle/abandoned/medbay)
"Zn" = (
/obj/effect/turf_decal{
	dir = 1
	},
/obj/structure/cable,
/turf/open/floor/iron/dark,
/area/shuttle/abandoned/medbay)
"Zq" = (
/obj/structure/sign/warning/chem_diamond{
	pixel_y = 32
	},
/turf/open/floor/iron/smooth,
/area/shuttle/abandoned/medbay)
"Zy" = (
/obj/machinery/airalarm/all_access{
	dir = 4;
	pixel_x = 24
	},
/turf/open/floor/iron/smooth,
/area/shuttle/abandoned/cargo)
"ZB" = (
/obj/structure/cable,
/turf/open/floor/iron/dark,
/area/shuttle/abandoned/crew)

(1,1,1) = {"
Oo
Oo
Oo
Oo
Oo
Oo
Oo
Oo
Oo
Oo
Oo
Oo
Oo
jV
jV
jV
jV
jV
jV
jV
jV
jV
Oo
Oo
Oo
Oo
"}
(2,1,1) = {"
Oo
Oo
Oo
Oo
Oo
Oo
Oo
Oo
Oo
Oo
Oo
Oo
jV
SG
La
La
KC
Pc
La
Xg
Xw
jV
Oo
Oo
Oo
Oo
"}
(3,1,1) = {"
Oo
Oo
Oo
Oo
Oo
Oo
Oo
Oo
Oo
Oo
Oo
jV
LP
wO
Hu
Hu
KC
Hu
Hu
Hu
Xw
jV
Oo
Oo
Oo
Oo
"}
(4,1,1) = {"
Oo
Oo
Oo
Oo
Oo
Oo
Oo
Oo
Oo
Oo
jV
LP
Pb
Hu
Hu
Hu
VD
Hu
OO
LP
jV
jV
Oo
Oo
Oo
Oo
"}
(5,1,1) = {"
Oo
Oo
Oo
Oo
Oo
Oo
Oo
Oo
Oo
jV
LP
bF
Pb
Ga
Hu
kL
KC
wV
LP
jV
Oo
Oo
Oo
Oo
Oo
Oo
"}
(6,1,1) = {"
Oo
Oo
Oo
Oo
Oo
Oo
Oo
Oo
Ca
KJ
jr
MP
Oj
TD
sO
TZ
pA
gw
Ca
Oo
Oo
Oo
Oo
Oo
Oo
Oo
"}
(7,1,1) = {"
Oo
Oo
Oo
Oo
Oo
Oo
fk
fk
KJ
Ca
Ca
oW
Zh
oW
Ca
cC
fh
Es
Ca
Oe
xr
Oo
Oo
Oo
Oo
Oo
"}
(8,1,1) = {"
Oo
Oo
Oo
Oo
Oo
Oo
fk
yQ
Ca
is
rJ
rJ
ct
rJ
Ca
UV
kq
fy
Ca
xr
uj
Oo
Oo
Oo
Oo
Oo
"}
(9,1,1) = {"
Oo
Oo
Oo
Oo
Oo
fk
DB
rn
Ca
rJ
rJ
rJ
Rg
rJ
Ca
sO
yw
Uo
Ca
xr
xr
Oo
Oo
Oo
Oo
Oo
"}
(10,1,1) = {"
Oo
Oo
Oo
Oo
fk
LP
kp
jy
Ca
PQ
rJ
rJ
ct
rJ
Ca
sh
yw
qw
Ca
Oe
xr
Oo
Oo
Oo
Oo
Oo
"}
(11,1,1) = {"
Oo
bU
bL
bL
DB
hU
kp
UI
xM
rJ
zA
rJ
ct
rJ
Ca
sO
yw
sO
Ca
Oo
Oo
Oo
Oo
Oo
Oo
Oo
"}
(12,1,1) = {"
Oo
Oo
bL
zx
Sg
vb
kM
Rr
Ca
rJ
Pw
rJ
ct
rJ
Ca
cC
fh
Es
Ca
jV
jV
jV
jV
Oo
Oo
Oo
"}
(13,1,1) = {"
bL
bL
bL
em
Sg
qx
kM
UI
Ca
pG
JK
YX
ct
rJ
Ca
sO
yw
xz
Ca
mY
Hu
SJ
jV
Oo
Oo
Oo
"}
(14,1,1) = {"
HV
hd
cy
yN
Sg
fk
Rq
fk
zj
rJ
JK
rJ
RJ
rJ
oW
zw
Qo
sO
Ca
pp
Hu
Kw
jV
Oo
Oo
Oo
"}
(15,1,1) = {"
ax
Ov
dX
cy
SK
gY
gY
ym
Zh
ct
AN
ct
Sh
ct
JB
Zn
yw
yw
eN
VD
KC
if
mW
Oo
Oo
Oo
"}
(16,1,1) = {"
HV
ar
cy
iQ
WR
sA
mG
sA
Vw
rJ
zA
rJ
Sh
rJ
oW
tt
yw
sO
Ca
BZ
Ga
Ac
jV
Oo
Oo
Oo
"}
(17,1,1) = {"
bL
bL
bL
ey
WR
Br
gY
pY
Vw
rJ
Gp
rJ
Sh
rJ
Ca
Zq
dI
sO
Ca
DA
Zy
Ik
jV
Oo
Oo
Oo
"}
(18,1,1) = {"
Oo
Oo
bL
Gh
JD
JD
Gi
JD
FD
pG
Gp
rJ
ct
rJ
Ca
cC
fh
Es
Ca
jV
jV
jV
jV
Oo
Oo
Oo
"}
(19,1,1) = {"
Oo
Oo
bL
bL
DB
Iw
ls
nm
GQ
rJ
rJ
rJ
ct
rJ
Ca
CC
wk
YV
Ca
Oo
Oo
Oo
Oo
Oo
Oo
Oo
"}
(20,1,1) = {"
Oo
Oo
Oo
Oo
fk
DB
Sm
yL
FD
TF
rJ
YX
ct
WI
Ca
sO
yw
gT
Ca
Oe
xr
Oo
Oo
Oo
Oo
Oo
"}
(21,1,1) = {"
Oo
Oo
Oo
Oo
Oo
fk
DB
jG
FD
Pr
rJ
rJ
ct
Tb
Ca
sO
yw
aw
Ca
xr
uj
Oo
Oo
Oo
Oo
Oo
"}
(22,1,1) = {"
Oo
Oo
Oo
Oo
Oo
Oo
fk
Fc
FD
Aj
rJ
rJ
ct
xL
Ca
sO
yw
Hu
Ca
xr
xr
Oo
Oo
Oo
Oo
Oo
"}
(23,1,1) = {"
Oo
Oo
Oo
Oo
Oo
Oo
fk
jV
LP
WT
Jl
Jl
Vl
Jl
jV
uA
VD
Hu
jV
Oe
xr
Oo
Oo
Oo
Oo
Oo
"}
(24,1,1) = {"
Oo
Oo
Oo
Oo
Oo
Oo
Oo
Oo
jV
LP
Gf
Gf
Vx
Gf
Gf
Gf
uY
Gf
Gf
Oo
Oo
Oo
Oo
Oo
Oo
Oo
"}
(25,1,1) = {"
Oo
Oo
Oo
Oo
Oo
Oo
Oo
Oo
Oo
jV
ku
cL
Wq
cL
Gf
it
ZB
it
LP
Gf
Oo
Oo
Oo
Oo
Oo
Oo
"}
(26,1,1) = {"
Oo
Oo
Oo
Oo
Oo
Oo
Oo
Oo
Oo
Oo
Gf
Nv
bQ
vS
Gf
aE
rU
Di
lY
ku
Gf
Gf
Oo
Oo
Oo
Oo
"}
(27,1,1) = {"
Oo
Oo
Oo
Oo
Oo
Oo
Oo
Oo
Oo
Oo
Oo
Gf
ku
zU
Gf
Di
ZB
nt
Di
sQ
Gf
Gf
Oo
Oo
Oo
Oo
"}
(28,1,1) = {"
Oo
Oo
Oo
Oo
Oo
Oo
Oo
Oo
Oo
Oo
Oo
Oo
Gf
ku
Gf
qs
ZB
Mi
aE
EV
mD
Gf
Oo
Oo
Oo
Oo
"}
(29,1,1) = {"
Oo
Oo
Oo
Oo
Oo
Oo
Oo
Oo
Oo
Oo
Oo
Oo
Oo
Gf
Gf
Gf
Gf
Gf
Gf
Gf
Gf
Gf
Oo
Oo
Oo
Oo
"}
