//MAP CONVERTED BY dmm2tgm.py THIS HEADER COMMENT PREVENTS RECONVERSION, DO NOT REMOVE
"a" = (
/obj/structure/frame/computer{
	anchored = 1
	},
/turf/open/floor/mineral/titanium/white,
/area/ruin/space/has_grav/whiteship)
"b" = (
/obj/structure/shuttle/engine/propulsion{
	dir = 4;
	tag = null
	},
/turf/open/floor/plating,
/area/ruin/space/has_grav/whiteship)
"c" = (
/obj/machinery/mass_driver{
	dir = 4;
	id = "oldship_gun"
	},
/turf/open/floor/plating,
/area/ruin/space/has_grav/whiteship)
"d" = (
/obj/machinery/door/airlock/shuttle,
/turf/open/floor/mineral/titanium/white,
/area/ruin/space/has_grav/whiteship)
"e" = (
/obj/structure/chair,
/turf/open/floor/mineral/titanium/white,
/area/ruin/space/has_grav/whiteship)
"f" = (
/obj/structure/rack,
/obj/item/clothing/mask/breath,
/turf/open/floor/mineral/titanium/white,
/area/ruin/space/has_grav/whiteship)
"g" = (
/obj/machinery/door/poddoor{
	id = "oldship_gun";
	name = "Pod Bay Door"
	},
/turf/open/floor/plating,
/area/ruin/space/has_grav/whiteship)
"h" = (
/obj/machinery/door/airlock/shuttle,
/obj/docking_port/mobile{
	dir = 2;
	dwidth = 11;
	height = 22;
	id = "whiteship";
	name = "NT Medical Ship";
	width = 35
	},
/obj/docking_port/stationary{
	dir = 2;
	dwidth = 11;
	height = 22;
	id = "whiteship_home";
	name = "ss13 Arrival Docking";
	width = 35
	},
/turf/open/floor/mineral/titanium/white,
/area/ruin/space/has_grav/whiteship)
"i" = (
/obj/structure/table,
/obj/item/tank/internals/oxygen,
/turf/open/floor/mineral/titanium/white,
/area/ruin/space/has_grav/whiteship)
"k" = (
/obj/machinery/sleeper{
	dir = 8;
	icon_state = "sleeper-open"
	},
/obj/effect/decal/remains/human,
/turf/open/floor/mineral/titanium/white,
/area/ruin/space/has_grav/whiteship)
"l" = (
/obj/machinery/door/airlock/glass,
/turf/open/floor/plating,
/area/ruin/space/has_grav/whiteship)
"n" = (
/obj/structure/rack,
/obj/item/tank/internals/emergency_oxygen,
/obj/item/tank/internals/emergency_oxygen,
/obj/item/tank/internals/emergency_oxygen,
/obj/item/tank/internals/emergency_oxygen,
/obj/item/storage/toolbox/mechanical,
/turf/open/floor/mineral/titanium/white,
/area/ruin/space/has_grav/whiteship)
"p" = (
/obj/item/shard{
	icon_state = "medium"
	},
/turf/open/floor/mineral/titanium/white,
/area/ruin/space/has_grav/whiteship)
"q" = (
/obj/structure/shuttle/engine/propulsion{
	dir = 4;
	icon_state = "propulsion_r";
	tag = null
	},
/turf/open/floor/plating,
/area/ruin/space/has_grav/whiteship)
"r" = (
/obj/machinery/door/airlock/shuttle,
/turf/open/floor/plating,
/area/ruin/space/has_grav/whiteship)
"s" = (
/obj/structure/shuttle/engine/heater{
	dir = 8;
	tag = null
	},
/obj/structure/window/reinforced{
	dir = 4
	},
/turf/open/floor/plating,
/area/ruin/space/has_grav/whiteship)
"u" = (
/turf/closed/wall/mineral/titanium,
/area/ruin/space/has_grav/whiteship)
"w" = (
/obj/structure/bed,
/obj/item/bedsheet,
/obj/structure/window/reinforced,
/obj/structure/window/reinforced{
	dir = 4
	},
/turf/open/floor/mineral/titanium/white,
/area/ruin/space/has_grav/whiteship)
"x" = (
/obj/effect/spawner/structure/window/reinforced,
/turf/open/floor/mineral/titanium/white,
/area/ruin/space/has_grav/whiteship)
"y" = (
/obj/structure/shuttle/engine/propulsion{
	dir = 4;
	icon_state = "propulsion_l";
	tag = null
	},
/turf/open/floor/plating,
/area/ruin/space/has_grav/whiteship)
"A" = (
/obj/structure/chair{
	dir = 1
	},
/turf/open/floor/mineral/titanium/white,
/area/ruin/space/has_grav/whiteship)
"B" = (
/turf/open/floor/mineral/titanium/white,
/area/ruin/space/has_grav/whiteship)
"C" = (
/obj/structure/chair{
	dir = 4
	},
/obj/effect/decal/remains/human,
/turf/open/floor/mineral/titanium/white,
/area/ruin/space/has_grav/whiteship)
"D" = (
/turf/closed/wall/mineral/titanium,
/area/space)
"F" = (
/obj/item/multitool,
/turf/open/floor/mineral/titanium/white,
/area/ruin/space/has_grav/whiteship)
"G" = (
/obj/machinery/computer/pod{
	id = "oldship_gun"
	},
/turf/open/floor/mineral/titanium/white,
/area/ruin/space/has_grav/whiteship)
"H" = (
/obj/structure/bed,
/obj/item/bedsheet,
/obj/structure/window/reinforced{
	dir = 1
	},
/obj/structure/window/reinforced{
	dir = 8
	},
/turf/open/floor/mineral/titanium/white,
/area/ruin/space/has_grav/whiteship)
"I" = (
/obj/machinery/door/window,
/turf/open/floor/mineral/titanium/white,
/area/ruin/space/has_grav/whiteship)
"J" = (
/turf/open/space/basic,
/area/template_noop)
"L" = (
/obj/machinery/door/window/right/directional/north,
/obj/effect/decal/remains/human,
/turf/open/floor/mineral/titanium/white,
/area/ruin/space/has_grav/whiteship)
"M" = (
/obj/effect/spawner/structure/window/reinforced,
/turf/open/floor/plating,
/area/ruin/space/has_grav/whiteship)
"N" = (
/obj/structure/table,
/turf/open/floor/mineral/titanium/white,
/area/ruin/space/has_grav/whiteship)
"O" = (
/obj/structure/table,
/obj/item/radio/off,
/turf/open/floor/mineral/titanium/white,
/area/ruin/space/has_grav/whiteship)
"P" = (
/obj/item/scalpel,
/turf/open/floor/mineral/titanium/white,
/area/ruin/space/has_grav/whiteship)
"Q" = (
/obj/structure/table,
/obj/item/screwdriver,
/turf/open/floor/mineral/titanium/white,
/area/ruin/space/has_grav/whiteship)
"R" = (
/obj/structure/table,
/obj/item/storage/medkit/regular{
	pixel_x = 6;
	pixel_y = -5
	},
/turf/open/floor/mineral/titanium/white,
/area/ruin/space/has_grav/whiteship)
"S" = (
/obj/machinery/portable_atmospherics/scrubber,
/turf/open/floor/mineral/titanium/white,
/area/ruin/space/has_grav/whiteship)
"T" = (
/obj/machinery/portable_atmospherics/canister/oxygen,
/turf/open/floor/mineral/titanium/white,
/area/ruin/space/has_grav/whiteship)
"V" = (
/obj/machinery/computer/shuttle/white_ship,
/turf/open/floor/mineral/titanium/white,
/area/ruin/space/has_grav/whiteship)
"W" = (
/obj/structure/table,
/obj/item/gun/energy/laser/retro,
/turf/open/floor/mineral/titanium/white,
/area/ruin/space/has_grav/whiteship)
"X" = (
/obj/item/stock_parts/cell{
	charge = 100;
	maxcharge = 15000
	},
/turf/open/floor/mineral/titanium/white,
/area/ruin/space/has_grav/whiteship)
"Y" = (
/obj/machinery/door/airlock/glass,
/turf/open/floor/mineral/titanium/white,
/area/ruin/space/has_grav/whiteship)
"Z" = (
/turf/open/floor/plating,
/area/ruin/space/has_grav/whiteship)

(1,1,1) = {"
J
J
J
J
J
J
J
J
u
u
d
u
u
J
J
J
J
J
J
J
J
"}
(2,1,1) = {"
J
J
J
J
J
J
J
J
u
u
B
u
u
J
J
J
J
J
J
J
J
"}
(3,1,1) = {"
J
J
J
J
J
J
J
J
u
B
B
B
u
J
J
J
J
J
J
J
J
"}
(4,1,1) = {"
J
J
J
J
J
J
J
J
u
B
B
B
u
J
J
J
J
J
J
J
J
"}
(5,1,1) = {"
J
J
J
J
J
J
J
J
u
B
B
B
u
J
J
J
J
J
J
J
J
"}
(6,1,1) = {"
J
J
J
J
J
J
J
J
u
B
B
B
u
J
J
J
J
J
J
J
J
"}
(7,1,1) = {"
J
J
J
J
J
J
J
J
u
B
B
B
u
J
J
J
J
J
J
J
J
"}
(8,1,1) = {"
J
J
J
J
J
J
J
J
u
B
B
B
u
J
J
J
J
J
J
J
J
"}
(9,1,1) = {"
J
J
J
J
J
J
J
J
u
B
B
T
u
J
J
J
J
J
J
J
J
"}
(10,1,1) = {"
J
J
J
J
J
J
J
J
u
u
B
u
u
J
J
J
J
J
J
J
J
"}
(11,1,1) = {"
J
J
J
J
J
J
J
J
u
u
d
u
u
J
J
J
J
J
J
J
J
"}
(12,1,1) = {"
J
J
J
J
J
J
J
J
J
u
B
u
J
J
J
J
J
J
J
J
J
"}
(13,1,1) = {"
J
J
J
J
J
J
J
J
D
u
d
u
D
J
J
J
J
J
J
J
J
"}
(14,1,1) = {"
J
J
J
J
J
J
J
D
D
u
B
u
D
D
J
J
J
J
J
J
J
"}
(15,1,1) = {"
u
y
b
b
b
q
J
D
D
B
B
B
D
D
J
y
b
b
b
q
u
"}
(16,1,1) = {"
u
u
s
s
s
u
u
u
B
B
B
B
B
u
u
u
s
s
s
u
u
"}
(17,1,1) = {"
J
u
u
Z
Z
u
u
u
B
B
B
B
B
u
u
u
Z
Z
u
u
J
"}
(18,1,1) = {"
J
J
u
u
Z
Z
u
B
B
B
B
B
B
S
u
Z
Z
u
u
J
J
"}
(19,1,1) = {"
J
J
J
u
u
r
u
u
u
x
Y
x
u
u
u
r
u
u
J
J
J
"}
(20,1,1) = {"
J
J
J
u
u
B
B
B
B
B
B
B
B
B
B
B
u
u
J
J
J
"}
(21,1,1) = {"
J
J
u
u
u
X
B
B
B
B
B
B
B
B
B
B
u
u
u
J
J
"}
(22,1,1) = {"
J
u
u
u
B
B
B
B
u
u
u
u
u
u
B
B
u
u
u
u
J
"}
(23,1,1) = {"
u
u
u
u
u
u
u
B
u
I
B
B
B
d
B
B
d
B
u
u
J
"}
(24,1,1) = {"
h
B
B
f
f
u
u
B
u
w
B
i
H
u
B
B
u
B
R
u
u
"}
(25,1,1) = {"
u
B
B
B
B
n
u
B
d
B
B
B
L
u
B
B
u
B
B
u
u
"}
(26,1,1) = {"
u
O
B
B
B
B
u
B
u
u
u
u
u
u
B
X
M
P
B
B
u
"}
(27,1,1) = {"
u
Q
B
B
B
B
d
B
B
B
B
B
B
B
B
B
M
B
B
k
u
"}
(28,1,1) = {"
u
B
B
B
B
B
u
u
B
B
B
B
B
B
B
F
M
B
B
B
u
"}
(29,1,1) = {"
u
B
B
B
B
u
u
u
u
M
Y
M
u
u
u
u
u
B
B
B
u
"}
(30,1,1) = {"
u
B
B
B
u
u
u
B
B
B
B
B
B
N
N
N
u
B
B
u
u
"}
(31,1,1) = {"
d
B
G
B
u
u
B
B
B
B
B
B
B
B
B
B
u
u
a
u
J
"}
(32,1,1) = {"
u
u
u
l
u
a
A
B
B
B
B
B
B
B
B
e
a
u
u
u
J
"}
(33,1,1) = {"
J
J
u
c
u
a
A
B
B
N
C
N
B
B
B
B
u
u
u
J
J
"}
(34,1,1) = {"
J
J
u
g
u
u
p
B
B
W
V
N
B
B
B
u
u
u
J
J
J
"}
(35,1,1) = {"
J
J
J
J
u
u
u
M
M
M
M
M
M
M
u
u
u
J
J
J
J
"}
