//MAP CONVERTED BY dmm2tgm.py THIS HEADER COMMENT PREVENTS RECONVERSION, DO NOT REMOVE
"a" = (
/obj/structure/frame/computer{
	anchored = 1
	},
/turf/open/floor/mineral/titanium/white,
/area/space)
"b" = (
/obj/structure/shuttle/engine/propulsion{
	tag = "icon-propulsion (EAST)";
	dir = 4
	},
/turf/open/floor/plating,
/area/space)
"c" = (
/obj/machinery/mass_driver{
	dir = 4;
	id = "oldship_gun"
	},
/turf/open/floor/plating,
/area/space)
"d" = (
/obj/machinery/door/airlock/shuttle,
/turf/open/floor/mineral/titanium/white,
/area/space)
"e" = (
/obj/structure/chair,
/turf/open/floor/mineral/titanium/white,
/area/space)
"f" = (
/obj/structure/rack,
/obj/item/clothing/mask/breath,
/turf/open/floor/mineral/titanium/white,
/area/space)
"g" = (
/obj/machinery/door/poddoor{
	id = "oldship_gun";
	name = "pod bay door"
	},
/turf/open/floor/plating,
/area/space)
"h" = (
/obj/machinery/door/airlock/shuttle,
/obj/docking_port/mobile{
	dir = 2;
	dwidth = 11;
	height = 22;
	id = "whiteship";
	name = "NT Medical Ship";
	roundstart_move = "whiteship_away";
	travelDir = 180;
	width = 35
	},
/obj/docking_port/stationary{
	dir = 2;
	dwidth = 11;
	height = 22;
	id = "whiteship_home";
	name = "ss13 Arrival Docking";
	width = 35
	},
/turf/open/floor/mineral/titanium/white,
/area/space)
"i" = (
/obj/structure/table,
/obj/item/tank/internals/oxygen,
/turf/open/floor/mineral/titanium/white,
/area/space)
"k" = (
/obj/machinery/sleeper{
	icon_state = "sleeper-open";
	dir = 8
	},
/obj/effect/decal/remains/human,
/turf/open/floor/mineral/titanium/white,
/area/space)
"l" = (
/obj/machinery/door/airlock/glass,
/turf/open/floor/plating,
/area/space)
"n" = (
/obj/structure/rack,
/obj/item/tank/internals/emergency_oxygen,
/obj/item/tank/internals/emergency_oxygen,
/obj/item/tank/internals/emergency_oxygen,
/obj/item/tank/internals/emergency_oxygen,
/obj/item/storage/toolbox/mechanical,
/turf/open/floor/mineral/titanium/white,
/area/space)
"p" = (
/obj/item/shard{
	icon_state = "medium"
	},
/turf/open/floor/mineral/titanium/white,
/area/space)
"q" = (
/obj/structure/shuttle/engine/propulsion{
	tag = "icon-propulsion_r (EAST)";
	icon_state = "propulsion_r";
	dir = 4
	},
/turf/open/floor/plating,
/area/space)
"r" = (
/obj/machinery/door/airlock/shuttle,
/turf/open/floor/plating,
/area/space)
"s" = (
/obj/structure/shuttle/engine/heater{
	tag = "icon-heater (WEST)";
	dir = 8
	},
/obj/structure/window/reinforced{
	dir = 4
	},
/turf/open/floor/plating,
/area/space)
"w" = (
/obj/structure/bed,
/obj/item/bedsheet,
/obj/structure/window/reinforced,
/obj/structure/window/reinforced{
	dir = 4
	},
/turf/open/floor/mineral/titanium/white,
/area/space)
"x" = (
/obj/effect/spawner/structure/window/reinforced,
/turf/open/floor/mineral/titanium/white,
/area/space)
"y" = (
/obj/structure/shuttle/engine/propulsion{
	tag = "icon-propulsion_l (EAST)";
	icon_state = "propulsion_l";
	dir = 4
	},
/turf/open/floor/plating,
/area/space)
"A" = (
/obj/structure/chair{
	dir = 1
	},
/turf/open/floor/mineral/titanium/white,
/area/space)
"B" = (
/turf/open/floor/mineral/titanium/white,
/area/space)
"C" = (
/obj/structure/chair{
	dir = 4
	},
/obj/effect/decal/remains/human,
/turf/open/floor/mineral/titanium/white,
/area/space)
"D" = (
/turf/closed/wall/mineral/titanium,
/area/space)
"F" = (
/obj/item/multitool,
/turf/open/floor/mineral/titanium/white,
/area/space)
"G" = (
/obj/machinery/computer/pod{
	id = "oldship_gun"
	},
/turf/open/floor/mineral/titanium/white,
/area/space)
"H" = (
/obj/structure/bed,
/obj/item/bedsheet,
/obj/structure/window/reinforced{
	dir = 1
	},
/obj/structure/window/reinforced{
	dir = 8
	},
/turf/open/floor/mineral/titanium/white,
/area/space)
"I" = (
/obj/machinery/door/window,
/turf/open/floor/mineral/titanium/white,
/area/space)
"J" = (
/turf/open/space/basic,
/area/space)
"L" = (
/obj/machinery/door/window/right/directional/north,
/obj/effect/decal/remains/human,
/turf/open/floor/mineral/titanium/white,
/area/space)
"M" = (
/obj/effect/spawner/structure/window/reinforced,
/turf/open/floor/plating,
/area/space)
"N" = (
/obj/structure/table,
/turf/open/floor/mineral/titanium/white,
/area/space)
"O" = (
/obj/structure/table,
/obj/item/radio/off,
/turf/open/floor/mineral/titanium/white,
/area/space)
"P" = (
/obj/item/scalpel,
/turf/open/floor/mineral/titanium/white,
/area/space)
"Q" = (
/obj/structure/table,
/obj/item/screwdriver,
/turf/open/floor/mineral/titanium/white,
/area/space)
"R" = (
/obj/structure/table,
/obj/item/storage/medkit/regular{
	pixel_x = 6;
	pixel_y = -5
	},
/turf/open/floor/mineral/titanium/white,
/area/space)
"S" = (
/obj/machinery/portable_atmospherics/scrubber,
/turf/open/floor/mineral/titanium/white,
/area/space)
"T" = (
/obj/machinery/portable_atmospherics/canister/oxygen,
/turf/open/floor/mineral/titanium/white,
/area/space)
"V" = (
/obj/machinery/computer/shuttle/white_ship,
/turf/open/floor/mineral/titanium/white,
/area/space)
"W" = (
/obj/structure/table,
/obj/item/gun/energy/laser/retro,
/turf/open/floor/mineral/titanium/white,
/area/space)
"X" = (
/obj/item/stock_parts/cell{
	charge = 100;
	maxcharge = 15000
	},
/turf/open/floor/mineral/titanium/white,
/area/space)
"Y" = (
/obj/machinery/door/airlock/glass,
/turf/open/floor/mineral/titanium/white,
/area/space)
"Z" = (
/turf/open/floor/plating,
/area/space)

(1,1,1) = {"
J
J
J
J
J
J
J
J
D
D
d
D
D
J
J
J
J
J
J
J
J
"}
(2,1,1) = {"
J
J
J
J
J
J
J
J
D
D
B
D
D
J
J
J
J
J
J
J
J
"}
(3,1,1) = {"
J
J
J
J
J
J
J
J
D
B
B
B
D
J
J
J
J
J
J
J
J
"}
(4,1,1) = {"
J
J
J
J
J
J
J
J
D
B
B
B
D
J
J
J
J
J
J
J
J
"}
(5,1,1) = {"
J
J
J
J
J
J
J
J
D
B
B
B
D
J
J
J
J
J
J
J
J
"}
(6,1,1) = {"
J
J
J
J
J
J
J
J
D
B
B
B
D
J
J
J
J
J
J
J
J
"}
(7,1,1) = {"
J
J
J
J
J
J
J
J
D
B
B
B
D
J
J
J
J
J
J
J
J
"}
(8,1,1) = {"
J
J
J
J
J
J
J
J
D
B
B
B
D
J
J
J
J
J
J
J
J
"}
(9,1,1) = {"
J
J
J
J
J
J
J
J
D
B
B
T
D
J
J
J
J
J
J
J
J
"}
(10,1,1) = {"
J
J
J
J
J
J
J
J
D
D
B
D
D
J
J
J
J
J
J
J
J
"}
(11,1,1) = {"
J
J
J
J
J
J
J
J
D
D
d
D
D
J
J
J
J
J
J
J
J
"}
(12,1,1) = {"
J
J
J
J
J
J
J
J
J
D
B
D
J
J
J
J
J
J
J
J
J
"}
(13,1,1) = {"
J
J
J
J
J
J
J
J
D
D
d
D
D
J
J
J
J
J
J
J
J
"}
(14,1,1) = {"
J
J
J
J
J
J
J
D
D
D
B
D
D
D
J
J
J
J
J
J
J
"}
(15,1,1) = {"
D
y
b
b
b
q
J
D
D
B
B
B
D
D
J
y
b
b
b
q
D
"}
(16,1,1) = {"
D
D
s
s
s
D
D
D
B
B
B
B
B
D
D
D
s
s
s
D
D
"}
(17,1,1) = {"
J
D
D
Z
Z
D
D
D
B
B
B
B
B
D
D
D
Z
Z
D
D
J
"}
(18,1,1) = {"
J
J
D
D
Z
Z
D
B
B
B
B
B
B
S
D
Z
Z
D
D
J
J
"}
(19,1,1) = {"
J
J
J
D
D
r
D
D
D
x
Y
x
D
D
D
r
D
D
J
J
J
"}
(20,1,1) = {"
J
J
J
D
D
B
B
B
B
B
B
B
B
B
B
B
D
D
J
J
J
"}
(21,1,1) = {"
J
J
D
D
D
X
B
B
B
B
B
B
B
B
B
B
D
D
D
J
J
"}
(22,1,1) = {"
J
D
D
D
B
B
B
B
D
D
D
D
D
D
B
B
D
D
D
D
J
"}
(23,1,1) = {"
D
D
D
D
D
D
D
B
D
I
B
B
B
d
B
B
d
B
D
D
J
"}
(24,1,1) = {"
h
B
B
f
f
D
D
B
D
w
B
i
H
D
B
B
D
B
R
D
D
"}
(25,1,1) = {"
D
B
B
B
B
n
D
B
d
B
B
B
L
D
B
B
D
B
B
D
D
"}
(26,1,1) = {"
D
O
B
B
B
B
D
B
D
D
D
D
D
D
B
X
M
P
B
B
D
"}
(27,1,1) = {"
D
Q
B
B
B
B
d
B
B
B
B
B
B
B
B
B
M
B
B
k
D
"}
(28,1,1) = {"
D
B
B
B
B
B
D
D
B
B
B
B
B
B
B
F
M
B
B
B
D
"}
(29,1,1) = {"
D
B
B
B
B
D
D
D
D
M
Y
M
D
D
D
D
D
B
B
B
D
"}
(30,1,1) = {"
D
B
B
B
D
D
D
B
B
B
B
B
B
N
N
N
D
B
B
D
D
"}
(31,1,1) = {"
d
B
G
B
D
D
B
B
B
B
B
B
B
B
B
B
D
D
a
D
J
"}
(32,1,1) = {"
D
D
D
l
D
a
A
B
B
B
B
B
B
B
B
e
a
D
D
D
J
"}
(33,1,1) = {"
J
J
D
c
D
a
A
B
B
N
C
N
B
B
B
B
D
D
D
J
J
"}
(34,1,1) = {"
J
J
D
g
D
D
p
B
B
W
V
N
B
B
B
D
D
D
J
J
J
"}
(35,1,1) = {"
J
J
J
J
D
D
D
M
M
M
M
M
M
M
D
D
D
J
J
J
J
"}
