//MAP CONVERTED BY dmm2tgm.py THIS HEADER COMMENT PREVENTS RECONVERSION, DO NOT REMOVE
"ae" = (
/obj/effect/turf_decal/siding/yellow/end,
/turf/open/indestructible/dark/smooth_large,
/area/deathmatch/fullbright)
"an" = (
/obj/effect/turf_decal/siding/blue,
/obj/effect/turf_decal/siding/blue{
	dir = 1
	},
/obj/effect/landmark/deathmatch_player_spawn,
/turf/open/indestructible/dark/smooth_large,
/area/deathmatch/fullbright)
"aw" = (
/obj/structure/lattice/catwalk/mining,
/obj/structure/railing{
	dir = 1
	},
/turf/open/chasm,
/area/deathmatch/fullbright)
"bF" = (
/obj/effect/turf_decal/siding/blue/corner{
	dir = 4
	},
/turf/open/indestructible/dark/smooth_large,
/area/deathmatch/fullbright)
"bV" = (
/obj/effect/turf_decal/siding/yellow/corner{
	dir = 1
	},
/obj/effect/turf_decal/siding/yellow/corner{
	dir = 8
	},
/turf/open/indestructible/large,
/area/deathmatch/fullbright)
"cu" = (
/obj/effect/turf_decal/siding/dark_red{
	dir = 6
	},
/turf/open/indestructible/dark/smooth_large,
/area/deathmatch/fullbright)
"cR" = (
/obj/structure/lattice/catwalk/mining,
/obj/structure/railing{
	dir = 8
	},
/turf/open/chasm,
/area/deathmatch/fullbright)
"dj" = (
/obj/effect/turf_decal/siding/dark_red{
	dir = 4
	},
/obj/effect/turf_decal/siding/dark_red{
	dir = 8
	},
/obj/effect/landmark/deathmatch_player_spawn,
/turf/open/indestructible/dark/smooth_large,
/area/deathmatch/fullbright)
"eb" = (
/obj/effect/turf_decal/siding/dark_green/corner{
	dir = 1
	},
/turf/open/indestructible/dark/smooth_large,
/area/deathmatch/fullbright)
"eL" = (
/obj/effect/turf_decal/siding/blue{
	dir = 8
	},
/obj/effect/turf_decal/siding/blue{
	dir = 4
	},
/obj/effect/landmark/deathmatch_player_spawn,
/turf/open/indestructible/dark/smooth_large,
/area/deathmatch/fullbright)
"eN" = (
/obj/effect/turf_decal/siding/blue/corner{
	dir = 4
	},
/turf/open/indestructible/large,
/area/deathmatch/fullbright)
"fp" = (
/obj/effect/turf_decal/siding/dark_green/end{
	dir = 8
	},
/turf/open/indestructible/dark/smooth_large,
/area/deathmatch/fullbright)
"gs" = (
/obj/effect/turf_decal/siding/blue/end{
	dir = 1
	},
/turf/open/indestructible/dark/smooth_large,
/area/deathmatch/fullbright)
"hk" = (
/obj/structure/lattice,
/turf/open/chasm,
/area/deathmatch/fullbright)
"im" = (
/obj/effect/turf_decal/siding/yellow/corner{
	dir = 8
	},
/turf/open/indestructible/large,
/area/deathmatch/fullbright)
"jb" = (
/obj/effect/turf_decal/siding/blue{
	dir = 4
	},
/turf/open/indestructible/dark/smooth_large,
/area/deathmatch/fullbright)
"jl" = (
/obj/effect/turf_decal/siding/blue,
/obj/effect/turf_decal/siding/blue{
	dir = 1
	},
/turf/open/indestructible/dark/smooth_large,
/area/deathmatch/fullbright)
"kR" = (
/turf/open/chasm,
/area/deathmatch/fullbright)
"kS" = (
/obj/effect/turf_decal/siding/dark_green{
	dir = 4
	},
/obj/effect/turf_decal/siding/dark_green{
	dir = 8
	},
/turf/open/indestructible/dark/smooth_large,
/area/deathmatch/fullbright)
"lJ" = (
/obj/effect/turf_decal/siding/dark_red{
	dir = 8
	},
/obj/effect/turf_decal/siding/dark_red{
	dir = 4
	},
/turf/open/indestructible/large,
/area/deathmatch/fullbright)
"ma" = (
/obj/effect/turf_decal/siding/dark_red/corner,
/turf/open/indestructible/large,
/area/deathmatch/fullbright)
"ok" = (
/obj/effect/turf_decal/siding/dark_red/end{
	dir = 4
	},
/turf/open/indestructible/dark/smooth_large,
/area/deathmatch/fullbright)
"os" = (
/obj/effect/turf_decal/siding/dark_green,
/obj/effect/turf_decal/siding/dark_green{
	dir = 1
	},
/turf/open/indestructible/dark/smooth_large,
/area/deathmatch/fullbright)
"ou" = (
/obj/effect/turf_decal/siding/dark_green/corner{
	dir = 4
	},
/obj/effect/turf_decal/siding/dark_green/corner{
	dir = 1
	},
/turf/open/indestructible/large,
/area/deathmatch/fullbright)
"oE" = (
/obj/effect/turf_decal/siding/dark_red{
	dir = 1
	},
/obj/effect/turf_decal/siding/dark_red,
/turf/open/indestructible/large,
/area/deathmatch/fullbright)
"oX" = (
/obj/effect/turf_decal/siding/blue{
	dir = 1
	},
/turf/open/indestructible/dark/smooth_large,
/area/deathmatch/fullbright)
"pg" = (
/obj/effect/turf_decal/siding/dark_green{
	dir = 1
	},
/turf/open/indestructible/large,
/area/deathmatch/fullbright)
"pE" = (
/obj/effect/turf_decal/siding/dark_green,
/obj/effect/turf_decal/siding/dark_green{
	dir = 1
	},
/turf/open/indestructible/large,
/area/deathmatch/fullbright)
"qg" = (
/obj/effect/turf_decal/siding/dark_green{
	dir = 8
	},
/turf/open/indestructible/dark/smooth_large,
/area/deathmatch/fullbright)
"qi" = (
/turf/open/space/basic,
/area/deathmatch/fullbright)
"qm" = (
/obj/effect/turf_decal/siding/yellow,
/turf/open/indestructible/large,
/area/deathmatch/fullbright)
"rS" = (
/obj/effect/turf_decal/siding/dark_red/end,
/turf/open/indestructible/dark/smooth_large,
/area/deathmatch/fullbright)
"rW" = (
/obj/effect/turf_decal/siding/dark_green,
/obj/effect/turf_decal/siding/dark_green{
	dir = 1
	},
/obj/effect/landmark/deathmatch_player_spawn,
/turf/open/indestructible/dark/smooth_large,
/area/deathmatch/fullbright)
"sb" = (
/obj/effect/turf_decal/siding/yellow/end{
	dir = 8
	},
/turf/open/indestructible/dark/smooth_large,
/area/deathmatch/fullbright)
"sL" = (
/obj/effect/turf_decal/siding/yellow/corner{
	dir = 8
	},
/obj/effect/turf_decal/siding/yellow{
	dir = 5
	},
/turf/open/indestructible/dark/smooth_large,
/area/deathmatch/fullbright)
"ud" = (
/obj/structure/lattice,
/obj/structure/lattice,
/turf/open/chasm,
/area/deathmatch/fullbright)
"vn" = (
/obj/effect/turf_decal/siding/blue{
	dir = 8
	},
/obj/effect/turf_decal/siding/blue{
	dir = 4
	},
/turf/open/indestructible/dark/smooth_large,
/area/deathmatch/fullbright)
"vz" = (
/obj/effect/turf_decal/siding/blue/corner,
/obj/effect/turf_decal/siding/blue/corner{
	dir = 4
	},
/turf/open/indestructible/large,
/area/deathmatch/fullbright)
"vF" = (
/obj/effect/turf_decal/siding/dark_red,
/turf/open/indestructible/large,
/area/deathmatch/fullbright)
"vV" = (
/obj/effect/turf_decal/siding/blue/corner{
	dir = 1
	},
/obj/effect/turf_decal/siding/blue/corner{
	dir = 4
	},
/turf/open/indestructible/large,
/area/deathmatch/fullbright)
"wl" = (
/obj/effect/turf_decal/siding/blue{
	dir = 1
	},
/turf/open/indestructible/large,
/area/deathmatch/fullbright)
"wD" = (
/obj/effect/turf_decal/siding/dark_red,
/obj/effect/turf_decal/siding/dark_red{
	dir = 1
	},
/obj/effect/landmark/deathmatch_player_spawn,
/turf/open/indestructible/dark/smooth_large,
/area/deathmatch/fullbright)
"xc" = (
/obj/structure/lattice/catwalk/mining,
/turf/open/chasm,
/area/deathmatch/fullbright)
"xv" = (
/obj/effect/turf_decal/siding/dark_red/corner{
	dir = 8
	},
/obj/effect/turf_decal/siding/dark_red/corner,
/turf/open/indestructible/large,
/area/deathmatch/fullbright)
"xQ" = (
/obj/effect/turf_decal/siding/blue{
	dir = 10
	},
/obj/effect/turf_decal/siding/blue/corner{
	dir = 4
	},
/turf/open/indestructible/dark/smooth_large,
/area/deathmatch/fullbright)
"zB" = (
/obj/effect/turf_decal/siding/yellow/corner{
	dir = 4
	},
/obj/effect/turf_decal/siding/yellow{
	dir = 10
	},
/turf/open/indestructible/large,
/area/deathmatch/fullbright)
"AS" = (
/obj/effect/turf_decal/siding/dark_green{
	dir = 8
	},
/turf/open/indestructible/large,
/area/deathmatch/fullbright)
"Bz" = (
/obj/effect/turf_decal/siding/blue/end{
	dir = 4
	},
/turf/open/indestructible/dark/smooth_large,
/area/deathmatch/fullbright)
"Cj" = (
/obj/effect/turf_decal/siding/dark_red{
	dir = 4
	},
/turf/open/indestructible/dark/smooth_large,
/area/deathmatch/fullbright)
"Cw" = (
/obj/effect/turf_decal/siding/dark_red/corner{
	dir = 4
	},
/obj/effect/turf_decal/siding/dark_red/corner,
/turf/open/indestructible/large,
/area/deathmatch/fullbright)
"CE" = (
/obj/effect/turf_decal/siding/dark_red,
/obj/effect/turf_decal/siding/dark_red{
	dir = 1
	},
/turf/open/indestructible/dark/smooth_large,
/area/deathmatch/fullbright)
"Dc" = (
/obj/effect/turf_decal/siding/yellow{
	dir = 1
	},
/obj/effect/turf_decal/siding/yellow,
/turf/open/indestructible/large,
/area/deathmatch/fullbright)
"Df" = (
/obj/effect/turf_decal/siding/yellow{
	dir = 10
	},
/turf/open/indestructible/dark/smooth_large,
/area/deathmatch/fullbright)
"Ei" = (
/obj/effect/turf_decal/siding/dark_red/corner,
/turf/open/indestructible/dark/smooth_large,
/area/deathmatch/fullbright)
"Es" = (
/obj/effect/turf_decal/siding/dark_green{
	dir = 1
	},
/turf/open/indestructible/dark/smooth_large,
/area/deathmatch/fullbright)
"EQ" = (
/obj/effect/turf_decal/siding/dark_green/corner{
	dir = 1
	},
/turf/open/indestructible/large,
/area/deathmatch/fullbright)
"Fd" = (
/turf/open/indestructible/light,
/area/deathmatch/fullbright)
"Ge" = (
/obj/effect/turf_decal/siding/yellow{
	dir = 4
	},
/obj/effect/turf_decal/siding/yellow{
	dir = 8
	},
/turf/open/indestructible/large,
/area/deathmatch/fullbright)
"Hg" = (
/obj/effect/turf_decal/siding/yellow{
	dir = 8
	},
/turf/open/indestructible/large,
/area/deathmatch/fullbright)
"Hm" = (
/obj/structure/lattice/catwalk/mining,
/obj/structure/railing,
/turf/open/chasm,
/area/deathmatch/fullbright)
"HM" = (
/obj/effect/turf_decal/siding/dark_red{
	dir = 4
	},
/obj/effect/turf_decal/siding/dark_red{
	dir = 8
	},
/turf/open/indestructible/dark/smooth_large,
/area/deathmatch/fullbright)
"Ij" = (
/obj/effect/turf_decal/siding/dark_green/end{
	dir = 1
	},
/turf/open/indestructible/dark/smooth_large,
/area/deathmatch/fullbright)
"IG" = (
/obj/effect/turf_decal/siding/yellow{
	dir = 8
	},
/obj/effect/turf_decal/siding/yellow{
	dir = 4
	},
/obj/effect/landmark/deathmatch_player_spawn,
/turf/open/indestructible/dark/smooth_large,
/area/deathmatch/fullbright)
"IP" = (
/obj/effect/turf_decal/siding/dark_green/corner,
/obj/effect/turf_decal/siding/dark_green{
	dir = 9
	},
/turf/open/indestructible/large,
/area/deathmatch/fullbright)
"Jq" = (
/obj/effect/turf_decal/siding/blue,
/obj/effect/turf_decal/siding/blue{
	dir = 1
	},
/turf/open/indestructible/large,
/area/deathmatch/fullbright)
"JS" = (
/obj/effect/turf_decal/siding/blue{
	dir = 5
	},
/turf/open/indestructible/dark/smooth_large,
/area/deathmatch/fullbright)
"Kn" = (
/obj/structure/lattice/catwalk/mining,
/obj/structure/railing{
	dir = 4
	},
/turf/open/chasm,
/area/deathmatch/fullbright)
"Ks" = (
/obj/effect/turf_decal/siding/yellow/corner{
	dir = 8
	},
/turf/open/indestructible/dark/smooth_large,
/area/deathmatch/fullbright)
"KD" = (
/obj/effect/turf_decal/siding/dark_green{
	dir = 4
	},
/obj/effect/turf_decal/siding/dark_green{
	dir = 8
	},
/obj/effect/landmark/deathmatch_player_spawn,
/turf/open/indestructible/dark/smooth_large,
/area/deathmatch/fullbright)
"LY" = (
/obj/effect/turf_decal/siding/blue/corner{
	dir = 8
	},
/obj/effect/turf_decal/siding/blue{
	dir = 5
	},
/turf/open/indestructible/large,
/area/deathmatch/fullbright)
"NE" = (
/obj/effect/turf_decal/siding/dark_red/corner{
	dir = 1
	},
/obj/effect/turf_decal/siding/dark_red{
	dir = 6
	},
/turf/open/indestructible/large,
/area/deathmatch/fullbright)
"NN" = (
/obj/effect/turf_decal/siding/dark_red{
	dir = 4
	},
/turf/open/indestructible/large,
/area/deathmatch/fullbright)
"Qn" = (
/obj/effect/turf_decal/siding/dark_green{
	dir = 4
	},
/obj/effect/turf_decal/siding/dark_green{
	dir = 8
	},
/turf/open/indestructible/large,
/area/deathmatch/fullbright)
"Qy" = (
/obj/effect/turf_decal/siding/yellow/corner,
/obj/effect/turf_decal/siding/yellow/corner{
	dir = 8
	},
/turf/open/indestructible/large,
/area/deathmatch/fullbright)
"QA" = (
/obj/effect/turf_decal/siding/blue{
	dir = 4
	},
/turf/open/indestructible/large,
/area/deathmatch/fullbright)
"QR" = (
/obj/effect/turf_decal/siding/yellow,
/obj/effect/turf_decal/siding/yellow{
	dir = 1
	},
/turf/open/indestructible/dark/smooth_large,
/area/deathmatch/fullbright)
"Rw" = (
/obj/effect/turf_decal/siding/yellow,
/obj/effect/turf_decal/siding/yellow{
	dir = 1
	},
/obj/effect/landmark/deathmatch_player_spawn,
/turf/open/indestructible/dark/smooth_large,
/area/deathmatch/fullbright)
"TA" = (
/obj/effect/turf_decal/siding/yellow,
/turf/open/indestructible/dark/smooth_large,
/area/deathmatch/fullbright)
"Vh" = (
/obj/effect/turf_decal/siding/yellow{
	dir = 8
	},
/turf/open/indestructible/dark/smooth_large,
/area/deathmatch/fullbright)
"Vn" = (
/obj/effect/turf_decal/siding/dark_green{
	dir = 6
	},
/obj/effect/turf_decal/siding/dark_green/corner{
	dir = 1
	},
/turf/open/indestructible/dark/smooth_large,
/area/deathmatch/fullbright)
"VH" = (
/obj/effect/turf_decal/siding/dark_green/corner{
	dir = 8
	},
/obj/effect/turf_decal/siding/dark_green/corner{
	dir = 1
	},
/turf/open/indestructible/large,
/area/deathmatch/fullbright)
"VK" = (
/obj/effect/turf_decal/siding/dark_red,
/turf/open/indestructible/dark/smooth_large,
/area/deathmatch/fullbright)
"Wr" = (
/obj/effect/turf_decal/siding/dark_green{
	dir = 9
	},
/turf/open/indestructible/dark/smooth_large,
/area/deathmatch/fullbright)
"Wz" = (
/obj/effect/turf_decal/siding/dark_red/corner,
/obj/effect/turf_decal/siding/dark_red{
	dir = 9
	},
/turf/open/indestructible/dark/smooth_large,
/area/deathmatch/fullbright)
"XR" = (
/obj/effect/turf_decal/siding/blue{
	dir = 8
	},
/obj/effect/turf_decal/siding/blue{
	dir = 4
	},
/turf/open/indestructible/large,
/area/deathmatch/fullbright)
"Yd" = (
/obj/effect/turf_decal/siding/yellow{
	dir = 8
	},
/obj/effect/turf_decal/siding/yellow{
	dir = 4
	},
/turf/open/indestructible/dark/smooth_large,
/area/deathmatch/fullbright)

(1,1,1) = {"
kR
kR
kR
kR
kR
kR
kR
kR
kR
kR
kR
kR
kR
kR
kR
kR
kR
kR
kR
kR
kR
kR
kR
kR
"}
(2,1,1) = {"
kR
Fd
Fd
Fd
Fd
Fd
Fd
Fd
Fd
Fd
Fd
kR
kR
Fd
Fd
Fd
Fd
Fd
Fd
Fd
Fd
Fd
Fd
kR
"}
(3,1,1) = {"
kR
Fd
Wz
HM
HM
HM
HM
dj
HM
HM
rS
Fd
Fd
gs
vn
vn
eL
vn
vn
vn
vn
xQ
Fd
kR
"}
(4,1,1) = {"
kR
Fd
CE
ma
NN
NN
NN
NN
NN
NN
Cw
NN
QA
vz
QA
QA
QA
QA
QA
QA
eN
jl
Fd
kR
"}
(5,1,1) = {"
kR
Fd
CE
vF
Fd
Kn
Kn
xc
Kn
Fd
oE
Ei
bF
Jq
Fd
Kn
xc
Kn
Kn
Fd
wl
jl
Fd
kR
"}
(6,1,1) = {"
kR
Fd
CE
vF
Hm
kR
kR
hk
kR
aw
oE
VK
oX
Jq
Hm
kR
hk
kR
kR
aw
wl
jl
Fd
kR
"}
(7,1,1) = {"
kR
Fd
CE
vF
Hm
kR
kR
ud
kR
aw
oE
VK
oX
Jq
Hm
kR
hk
kR
kR
aw
wl
jl
Fd
kR
"}
(8,1,1) = {"
kR
Fd
wD
vF
xc
hk
hk
hk
hk
xc
oE
VK
oX
Jq
xc
hk
ud
ud
hk
xc
wl
an
Fd
kR
"}
(9,1,1) = {"
kR
Fd
CE
vF
Hm
kR
kR
hk
kR
aw
oE
VK
oX
Jq
Hm
kR
ud
kR
kR
aw
wl
jl
Fd
kR
"}
(10,1,1) = {"
kR
Fd
CE
vF
Fd
cR
cR
xc
cR
Fd
oE
VK
oX
Jq
Fd
cR
xc
cR
cR
Fd
wl
jl
Fd
kR
"}
(11,1,1) = {"
kR
Fd
ok
xv
lJ
lJ
lJ
lJ
lJ
lJ
NE
VK
oX
LY
XR
XR
XR
XR
XR
XR
vV
Bz
Fd
kR
"}
(12,1,1) = {"
kR
kR
Fd
vF
Ei
Cj
Cj
Cj
Cj
Cj
Cj
cu
JS
jb
jb
jb
jb
jb
jb
bF
wl
Fd
kR
kR
"}
(13,1,1) = {"
kR
kR
Fd
qm
Ks
Vh
Vh
Vh
Vh
Vh
Vh
Df
Wr
qg
qg
qg
qg
qg
qg
eb
pg
Fd
kR
kR
"}
(14,1,1) = {"
kR
Fd
sb
Qy
Ge
Ge
Ge
Ge
Ge
Ge
zB
TA
Es
IP
Qn
Qn
Qn
Qn
Qn
Qn
ou
fp
Fd
kR
"}
(15,1,1) = {"
kR
Fd
QR
qm
Fd
Kn
Kn
xc
Kn
Fd
Dc
TA
Es
pE
Fd
Kn
xc
Kn
Kn
Fd
pg
os
Fd
kR
"}
(16,1,1) = {"
kR
Fd
QR
qm
Hm
kR
kR
hk
kR
aw
Dc
TA
Es
pE
Hm
kR
hk
kR
kR
aw
pg
os
Fd
kR
"}
(17,1,1) = {"
kR
Fd
Rw
qm
xc
hk
hk
hk
hk
xc
Dc
TA
Es
pE
xc
hk
hk
hk
hk
xc
pg
rW
Fd
kR
"}
(18,1,1) = {"
kR
Fd
QR
qm
Hm
kR
kR
hk
kR
aw
Dc
TA
Es
pE
Hm
kR
hk
kR
kR
aw
pg
os
Fd
kR
"}
(19,1,1) = {"
kR
Fd
QR
qm
Hm
qi
kR
hk
kR
aw
Dc
TA
Es
pE
Hm
kR
hk
kR
kR
aw
pg
os
Fd
kR
"}
(20,1,1) = {"
kR
Fd
QR
qm
Fd
cR
cR
xc
cR
Fd
Dc
Ks
eb
pE
Fd
cR
xc
cR
cR
Fd
pg
os
Fd
kR
"}
(21,1,1) = {"
kR
Fd
QR
im
Hg
Hg
Hg
Hg
Hg
Hg
bV
Hg
AS
VH
AS
AS
AS
AS
AS
AS
EQ
os
Fd
kR
"}
(22,1,1) = {"
kR
Fd
sL
Yd
Yd
Yd
Yd
IG
Yd
Yd
ae
Fd
Fd
Ij
kS
kS
KD
kS
kS
kS
kS
Vn
Fd
kR
"}
(23,1,1) = {"
kR
Fd
Fd
Fd
Fd
Fd
Fd
Fd
Fd
Fd
Fd
kR
kR
Fd
Fd
Fd
Fd
Fd
Fd
Fd
Fd
Fd
Fd
kR
"}
(24,1,1) = {"
kR
kR
kR
kR
kR
kR
kR
kR
kR
kR
kR
kR
kR
kR
kR
kR
kR
kR
kR
kR
kR
kR
kR
kR
"}
