//MAP CONVERTED BY dmm2tgm.py THIS HEADER COMMENT PREVENTS RECONVERSION, DO NOT REMOVE
"a" = (
/obj/effect/turf_decal/tile/red/full,
/turf/open/indestructible/dark/smooth_large,
/area/deathmatch)
"c" = (
/obj/effect/landmark/deathmatch_player_spawn,
/turf/open/indestructible/white/smooth_large,
/area/deathmatch)
"e" = (
/obj/structure/barricade/security/murderdome,
/turf/open/indestructible/white/smooth_large,
/area/deathmatch)
"f" = (
/obj/effect/turf_decal/tile/dark_green/full,
/turf/open/indestructible/dark/smooth_large,
/area/deathmatch)
"g" = (
/obj/effect/turf_decal/tile/yellow/full,
/obj/machinery/light/directional/east,
/turf/open/indestructible/white/smooth_large,
/area/deathmatch)
"h" = (
/turf/closed/indestructible/riveted,
/area/deathmatch)
"i" = (
/obj/effect/turf_decal/tile/red/full,
/obj/structure/barricade/security/murderdome,
/turf/open/indestructible/dark/smooth_large,
/area/deathmatch)
"j" = (
/obj/effect/turf_decal/tile/yellow/full,
/obj/machinery/light/directional/west,
/turf/open/indestructible/white/smooth_large,
/area/deathmatch)
"k" = (
/turf/open/indestructible/dark/smooth_large,
/area/deathmatch)
"l" = (
/obj/structure/barricade/security/murderdome,
/obj/machinery/light/floor,
/turf/open/indestructible/white/smooth_large,
/area/deathmatch)
"m" = (
/obj/structure/mystery_box/tdome,
/turf/open/indestructible/white/smooth_large,
/area/deathmatch)
"o" = (
/obj/effect/turf_decal/tile/yellow/full,
/obj/machinery/light/directional/south,
/turf/open/indestructible/white/smooth_large,
/area/deathmatch)
"p" = (
/turf/open/chasm/true,
/area/deathmatch)
"q" = (
/obj/machinery/light/directional/north,
/turf/open/indestructible/dark/smooth_large,
/area/deathmatch)
"s" = (
/obj/structure/mystery_box/tdome,
/obj/effect/turf_decal/tile/yellow/full,
/turf/open/indestructible/white/smooth_large,
/area/deathmatch)
"u" = (
/obj/structure/barricade/security/murderdome,
/obj/machinery/light/floor,
/turf/open/indestructible/dark/smooth_large,
/area/deathmatch)
"w" = (
/turf/open/lava/airless,
/area/deathmatch)
"x" = (
/turf/open/indestructible/white/smooth_large,
/area/deathmatch)
"z" = (
/obj/machinery/light/directional/west,
/turf/open/indestructible/dark/smooth_large,
/area/deathmatch)
"B" = (
/obj/structure/barricade/security/murderdome,
/turf/open/indestructible/dark/smooth_large,
/area/deathmatch)
"C" = (
/obj/effect/landmark/deathmatch_player_spawn,
/obj/effect/turf_decal/tile/yellow/full,
/turf/open/indestructible/white/smooth_large,
/area/deathmatch)
"D" = (
/obj/structure/mystery_box/tdome,
/turf/open/indestructible/dark/smooth_large,
/area/deathmatch)
"I" = (
/turf/closed/indestructible/fakeglass,
/area/deathmatch)
"K" = (
/obj/effect/landmark/deathmatch_player_spawn,
/turf/open/indestructible/dark/smooth_large,
/area/deathmatch)
"L" = (
/turf/template_noop,
/area/template_noop)
"O" = (
/obj/machinery/light/directional/east,
/turf/open/indestructible/dark/smooth_large,
/area/deathmatch)
"P" = (
/obj/effect/turf_decal/tile/yellow/full,
/obj/machinery/light/directional/north,
/turf/open/indestructible/white/smooth_large,
/area/deathmatch)
"Q" = (
/obj/effect/turf_decal/tile/yellow/full,
/turf/open/indestructible/white/smooth_large,
/area/deathmatch)
"U" = (
/obj/effect/turf_decal/tile/dark_green/full,
/obj/structure/barricade/security/murderdome,
/turf/open/indestructible/dark/smooth_large,
/area/deathmatch)
"V" = (
/obj/structure/barricade/security/murderdome,
/obj/effect/turf_decal/tile/yellow/full,
/turf/open/indestructible/white/smooth_large,
/area/deathmatch)
"W" = (
/obj/machinery/light/directional/south,
/turf/open/indestructible/dark/smooth_large,
/area/deathmatch)

(1,1,1) = {"
L
L
L
L
L
L
L
L
L
L
L
L
L
L
L
L
h
h
h
h
h
h
h
h
h
h
h
h
h
h
h
h
h
L
L
L
L
L
L
L
L
L
L
L
L
L
L
L
L
"}
(2,1,1) = {"
L
L
L
L
L
L
L
L
L
L
L
L
L
h
h
h
h
p
p
p
p
p
p
p
p
p
p
p
p
p
p
p
h
h
h
h
L
L
L
L
L
L
L
L
L
L
L
L
L
"}
(3,1,1) = {"
L
L
L
L
L
L
L
L
L
L
L
h
h
h
p
p
p
p
p
p
p
p
p
p
p
p
p
p
p
p
p
p
p
p
p
h
h
h
L
L
L
L
L
L
L
L
L
L
L
"}
(4,1,1) = {"
L
L
L
L
L
L
L
L
L
h
h
h
p
p
p
p
p
p
p
p
p
p
p
p
p
p
p
p
p
p
p
p
p
p
p
p
p
h
h
h
L
L
L
L
L
L
L
L
L
"}
(5,1,1) = {"
L
L
L
L
L
L
L
L
h
h
p
p
p
p
p
p
p
p
p
p
i
i
a
a
a
a
a
i
i
p
p
p
p
p
p
p
p
p
p
h
h
L
L
L
L
L
L
L
L
"}
(6,1,1) = {"
L
L
L
L
L
L
L
h
h
p
p
p
p
p
p
p
p
a
a
i
i
x
x
x
x
x
x
x
i
i
a
a
p
p
p
p
p
p
p
p
h
h
L
L
L
L
L
L
L
"}
(7,1,1) = {"
L
L
L
L
L
L
h
h
p
p
p
p
p
p
p
a
a
a
x
x
x
x
x
x
c
x
x
x
x
x
x
a
a
a
p
p
p
p
p
p
p
h
h
L
L
L
L
L
L
"}
(8,1,1) = {"
L
L
L
L
L
h
h
p
p
p
p
p
p
i
i
a
x
x
x
x
x
x
x
x
x
x
x
x
x
x
x
x
x
a
i
i
p
p
p
p
p
p
h
h
L
L
L
L
L
"}
(9,1,1) = {"
L
L
L
L
h
h
p
p
p
p
p
p
i
i
x
x
x
x
x
k
O
k
k
k
k
k
k
k
O
k
x
x
x
x
x
i
i
p
p
p
p
p
p
h
h
L
L
L
L
"}
(10,1,1) = {"
L
L
L
h
h
p
p
p
p
p
p
a
a
x
x
x
k
k
k
D
h
I
I
k
k
k
I
I
h
D
k
k
k
x
x
x
a
a
p
p
p
p
p
p
h
h
L
L
L
"}
(11,1,1) = {"
L
L
L
h
p
p
p
p
p
p
f
a
x
x
k
k
W
h
h
h
h
w
I
k
k
k
I
w
h
h
h
h
q
k
k
x
x
a
a
p
p
p
p
p
p
h
L
L
L
"}
(12,1,1) = {"
L
L
h
h
p
p
p
p
p
f
f
c
x
k
k
I
I
h
w
w
w
w
I
k
Q
k
I
w
w
w
w
h
I
I
k
k
x
c
a
a
p
p
p
p
p
h
h
L
L
"}
(13,1,1) = {"
L
L
h
p
p
p
p
p
U
f
x
x
k
k
I
I
w
w
w
w
h
I
I
Q
Q
Q
I
I
h
w
w
w
w
I
I
k
k
x
x
a
i
p
p
p
p
p
h
L
L
"}
(14,1,1) = {"
L
h
h
p
p
p
p
U
U
x
x
k
k
I
I
w
w
w
h
h
h
P
Q
Q
Q
Q
Q
o
h
h
h
w
w
w
I
I
k
k
x
x
i
i
p
p
p
p
h
h
L
"}
(15,1,1) = {"
L
h
p
p
p
p
p
U
x
x
k
k
I
I
w
w
I
I
h
s
Q
Q
Q
Q
C
Q
Q
Q
Q
s
h
I
I
w
w
I
I
k
k
x
x
i
p
p
p
p
p
h
L
"}
(16,1,1) = {"
L
h
p
p
p
p
f
f
x
x
k
I
I
w
w
I
I
Q
j
Q
Q
Q
V
Q
Q
Q
V
Q
Q
Q
j
Q
I
I
w
w
I
I
k
x
x
a
a
p
p
p
p
h
L
"}
(17,1,1) = {"
h
h
p
p
p
p
f
x
x
k
O
I
w
w
I
I
Q
k
k
B
k
Q
Q
B
B
B
k
k
Q
V
Q
Q
Q
I
I
w
w
I
O
k
x
x
a
p
p
p
p
h
h
"}
(18,1,1) = {"
h
p
p
p
p
f
f
x
x
k
h
h
w
w
I
Q
k
K
k
k
B
k
k
x
x
x
x
x
B
k
Q
C
Q
Q
I
w
w
h
h
k
x
x
a
a
p
p
p
p
h
"}
(19,1,1) = {"
h
p
p
p
p
f
x
x
x
k
h
w
w
h
h
P
k
k
k
k
k
x
x
x
x
x
x
x
x
x
k
Q
Q
o
h
h
w
w
h
k
x
x
x
a
p
p
p
p
h
"}
(20,1,1) = {"
h
p
p
p
p
U
x
x
k
D
h
w
w
h
s
Q
B
k
k
k
x
x
k
k
k
x
x
x
x
x
x
k
V
Q
s
h
w
w
h
D
k
x
x
i
p
p
p
p
h
"}
(21,1,1) = {"
h
p
p
p
U
U
x
x
W
h
h
w
h
h
Q
Q
Q
B
k
x
x
k
k
k
k
k
x
x
k
x
x
B
Q
Q
Q
h
h
w
h
h
q
x
x
i
i
p
p
p
h
"}
(22,1,1) = {"
h
p
p
p
U
x
x
x
k
I
w
w
I
j
Q
Q
Q
Q
k
x
k
k
x
e
u
B
x
x
x
k
x
x
k
Q
Q
j
I
w
w
I
k
x
x
x
i
p
p
p
h
"}
(23,1,1) = {"
h
p
p
p
f
x
x
x
k
I
I
I
I
Q
Q
V
Q
k
x
x
x
k
k
k
k
x
x
x
x
k
x
x
k
V
Q
Q
I
I
I
I
k
x
x
x
a
p
p
p
h
"}
(24,1,1) = {"
h
p
p
p
f
x
x
x
k
k
k
k
Q
Q
Q
Q
V
k
x
x
x
e
x
x
m
x
k
e
x
k
x
x
B
Q
Q
Q
Q
k
k
k
k
x
x
x
a
p
p
p
h
"}
(25,1,1) = {"
h
p
p
p
f
x
c
x
k
k
k
Q
Q
Q
C
Q
V
k
x
x
x
l
x
m
l
m
k
u
k
x
x
x
B
Q
C
Q
Q
Q
k
k
k
x
c
x
a
p
p
p
h
"}
(26,1,1) = {"
h
p
p
p
f
x
x
x
k
k
k
k
Q
Q
Q
Q
V
k
x
x
x
e
x
x
m
x
k
e
x
k
x
x
B
Q
Q
Q
Q
k
k
k
k
x
x
x
a
p
p
p
h
"}
(27,1,1) = {"
h
p
p
p
f
x
x
x
k
I
I
I
I
Q
Q
V
Q
k
x
x
x
k
k
k
k
x
x
x
x
k
x
x
k
V
Q
Q
I
I
I
I
k
x
x
x
a
p
p
p
h
"}
(28,1,1) = {"
h
p
p
p
U
x
x
x
k
I
w
w
I
g
Q
Q
Q
Q
k
x
k
k
x
e
u
B
x
x
x
k
x
x
k
Q
Q
g
I
w
w
I
k
x
x
x
i
p
p
p
h
"}
(29,1,1) = {"
h
p
p
p
U
U
x
x
W
h
h
w
h
h
Q
Q
Q
B
k
x
x
k
k
k
k
k
x
x
k
x
x
B
Q
Q
Q
h
h
w
h
h
q
x
x
i
i
p
p
p
h
"}
(30,1,1) = {"
h
p
p
p
p
U
x
x
k
D
h
w
w
h
s
Q
B
k
k
k
x
x
k
k
k
x
x
x
x
x
x
k
V
Q
s
h
w
w
h
D
k
x
x
i
p
p
p
p
h
"}
(31,1,1) = {"
h
p
p
p
p
f
x
x
x
k
h
w
w
h
h
P
k
k
k
k
k
x
x
x
x
x
x
x
x
x
k
Q
Q
o
h
h
w
w
h
k
x
x
x
a
p
p
p
p
h
"}
(32,1,1) = {"
h
p
p
p
p
f
f
x
x
k
h
h
w
w
I
Q
k
K
k
k
B
k
k
x
x
x
x
x
B
k
Q
C
Q
Q
I
w
w
h
h
k
x
x
a
a
p
p
p
p
h
"}
(33,1,1) = {"
h
h
p
p
p
p
f
x
x
k
z
I
w
w
I
I
Q
k
k
B
k
Q
Q
B
B
B
k
k
Q
V
Q
Q
Q
I
I
w
w
I
z
k
x
x
a
p
p
p
p
h
h
"}
(34,1,1) = {"
L
h
p
p
p
p
f
f
x
x
k
I
I
w
w
I
I
Q
g
Q
Q
Q
V
Q
Q
Q
V
Q
Q
Q
g
Q
I
I
w
w
I
I
k
x
x
a
a
p
p
p
p
h
L
"}
(35,1,1) = {"
L
h
p
p
p
p
p
U
x
x
k
k
I
I
w
w
I
I
h
s
Q
Q
Q
Q
C
Q
Q
Q
Q
s
h
I
I
w
w
I
I
k
k
x
x
i
p
p
p
p
p
h
L
"}
(36,1,1) = {"
L
h
h
p
p
p
p
U
U
x
x
k
k
I
I
w
w
w
h
h
h
P
Q
Q
Q
Q
Q
o
h
h
h
w
w
w
I
I
k
k
x
x
i
i
p
p
p
p
h
h
L
"}
(37,1,1) = {"
L
L
h
p
p
p
p
p
U
f
x
x
k
k
I
I
w
w
w
w
h
I
I
Q
Q
Q
I
I
h
w
w
w
w
I
I
k
k
x
x
a
i
p
p
p
p
p
h
L
L
"}
(38,1,1) = {"
L
L
h
h
p
p
p
p
p
f
f
c
x
k
k
I
I
h
w
w
w
w
I
k
Q
k
I
w
w
w
w
h
I
I
k
k
x
c
a
a
p
p
p
p
p
h
h
L
L
"}
(39,1,1) = {"
L
L
L
h
p
p
p
p
p
p
f
f
x
x
k
k
W
h
h
h
h
w
I
k
k
k
I
w
h
h
h
h
q
k
k
x
x
f
a
p
p
p
p
p
p
h
L
L
L
"}
(40,1,1) = {"
L
L
L
h
h
p
p
p
p
p
p
f
f
x
x
x
k
k
k
D
h
I
I
k
k
k
I
I
h
D
k
k
k
x
x
x
f
f
p
p
p
p
p
p
h
h
L
L
L
"}
(41,1,1) = {"
L
L
L
L
h
h
p
p
p
p
p
p
U
U
x
x
x
x
x
k
z
k
k
k
k
k
k
k
z
k
x
x
x
x
x
U
U
p
p
p
p
p
p
h
h
L
L
L
L
"}
(42,1,1) = {"
L
L
L
L
L
h
h
p
p
p
p
p
p
U
U
f
x
x
x
x
x
x
x
x
x
x
x
x
x
x
x
x
x
f
U
U
p
p
p
p
p
p
h
h
L
L
L
L
L
"}
(43,1,1) = {"
L
L
L
L
L
L
h
h
p
p
p
p
p
p
p
f
f
f
x
x
x
x
x
x
c
x
x
x
x
x
x
f
f
f
p
p
p
p
p
p
p
h
h
L
L
L
L
L
L
"}
(44,1,1) = {"
L
L
L
L
L
L
L
h
h
p
p
p
p
p
p
p
p
f
f
U
U
x
x
x
x
x
x
x
U
U
f
f
p
p
p
p
p
p
p
p
h
h
L
L
L
L
L
L
L
"}
(45,1,1) = {"
L
L
L
L
L
L
L
L
h
h
p
p
p
p
p
p
p
p
p
p
U
U
f
f
f
f
f
U
U
p
p
p
p
p
p
p
p
p
p
h
h
L
L
L
L
L
L
L
L
"}
(46,1,1) = {"
L
L
L
L
L
L
L
L
L
h
h
h
p
p
p
p
p
p
p
p
p
p
p
p
p
p
p
p
p
p
p
p
p
p
p
p
p
h
h
h
L
L
L
L
L
L
L
L
L
"}
(47,1,1) = {"
L
L
L
L
L
L
L
L
L
L
L
h
h
h
p
p
p
p
p
p
p
p
p
p
p
p
p
p
p
p
p
p
p
p
p
h
h
h
L
L
L
L
L
L
L
L
L
L
L
"}
(48,1,1) = {"
L
L
L
L
L
L
L
L
L
L
L
L
L
h
h
h
h
p
p
p
p
p
p
p
p
p
p
p
p
p
p
p
h
h
h
h
L
L
L
L
L
L
L
L
L
L
L
L
L
"}
(49,1,1) = {"
L
L
L
L
L
L
L
L
L
L
L
L
L
L
L
L
h
h
h
h
h
h
h
h
h
h
h
h
h
h
h
h
h
L
L
L
L
L
L
L
L
L
L
L
L
L
L
L
L
"}
