//MAP CONVERTED BY dmm2tgm.py THIS HEADER COMMENT PREVENTS RECONVERSION, DO NOT REMOVE
"a" = (
/turf/closed/wall/r_wall,
/area/station/command/heads_quarters/cmo)
"b" = (
/obj/effect/turf_decal/tile/blue{
	dir = 1
	},
/obj/structure/cable,
/obj/item/kirbyplants/random,
/obj/machinery/light_switch/directional/north,
/turf/open/floor/iron{
	heat_capacity = 1e+006
	},
/area/station/command/heads_quarters/cmo)
"c" = (
/obj/effect/turf_decal/tile/blue{
	dir = 1
	},
/obj/structure/cable,
/obj/machinery/atmospherics/pipe/smart/manifold4w/supply/hidden/layer4,
/obj/machinery/atmospherics/pipe/smart/manifold4w/scrubbers/hidden/layer2,
/obj/structure/disposalpipe/segment,
/turf/open/floor/iron{
	heat_capacity = 1e+006
	},
/area/station/command/heads_quarters/cmo)
"e" = (
/obj/effect/turf_decal/tile/blue{
	dir = 1
	},
/obj/structure/filingcabinet/chestdrawer,
/turf/open/floor/iron{
	heat_capacity = 1e+006
	},
/area/station/command/heads_quarters/cmo)
"f" = (
/obj/machinery/door/airlock/command{
	name = "Chief Medical Officer's Office"
	},
/obj/effect/mapping_helpers/airlock/cyclelink_helper_multi{
	cycle_id = "CMO"
	},
/obj/structure/cable,
/obj/machinery/atmospherics/pipe/smart/manifold4w/supply/hidden/layer4,
/obj/machinery/atmospherics/pipe/smart/manifold4w/scrubbers/hidden/layer2,
/obj/modular_map_connector,
/obj/structure/disposalpipe/segment,
/obj/effect/mapping_helpers/airlock/access/any/medical/cmo,
/turf/open/floor/iron{
	heat_capacity = 1e+006
	},
/area/station/command/heads_quarters/cmo)
"g" = (
/obj/structure/bed,
/obj/item/bedsheet/cmo,
/turf/open/floor/iron/dark,
/area/station/command/heads_quarters/cmo)
"h" = (
/obj/effect/turf_decal/tile/blue{
	dir = 1
	},
/obj/machinery/disposal/bin,
/obj/structure/disposalpipe/trunk{
	dir = 1
	},
/turf/open/floor/iron{
	heat_capacity = 1e+006
	},
/area/station/command/heads_quarters/cmo)
"i" = (
/obj/effect/turf_decal/tile/blue{
	dir = 1
	},
/obj/machinery/power/apc/auto_name/directional/north,
/obj/structure/cable,
/obj/item/radio/intercom/directional/west,
/turf/open/floor/iron{
	heat_capacity = 1e+006
	},
/area/station/command/heads_quarters/cmo)
"k" = (
/obj/effect/turf_decal/tile/blue{
	dir = 1
	},
/obj/machinery/newscaster/directional/west,
/obj/machinery/light/directional/west,
/turf/open/floor/iron{
	heat_capacity = 1e+006
	},
/area/station/command/heads_quarters/cmo)
"l" = (
/obj/effect/turf_decal/tile/blue{
	dir = 4
	},
/obj/effect/turf_decal/tile/blue{
	dir = 8
	},
/obj/structure/chair/comfy/lime{
	dir = 1
	},
/obj/machinery/atmospherics/pipe/smart/manifold4w/supply/hidden/layer4,
/turf/open/floor/iron/white,
/area/station/command/heads_quarters/cmo)
"m" = (
/obj/effect/turf_decal/tile/blue{
	dir = 1
	},
/obj/machinery/modular_computer/console/preset/id{
	dir = 8
	},
/obj/machinery/requests_console/directional/east{
	announcementConsole = 1;
	department = "Chief Medical Officer's Desk";
	name = "Chief Medical Officer's Requests Console"
	},
/obj/machinery/computer/security/telescreen/cmo{
	pixel_y = 27
	},
/turf/open/floor/iron{
	heat_capacity = 1e+006
	},
/area/station/command/heads_quarters/cmo)
"n" = (
/obj/effect/turf_decal/tile/blue{
	dir = 8
	},
/obj/effect/turf_decal/tile/blue{
	dir = 4
	},
/obj/machinery/atmospherics/pipe/smart/manifold4w/scrubbers/hidden/layer2,
/obj/structure/table/glass,
/obj/item/toy/figure/cmo,
/obj/machinery/atmospherics/pipe/smart/manifold4w/supply/hidden/layer4,
/turf/open/floor/iron/white,
/area/station/command/heads_quarters/cmo)
"o" = (
/obj/effect/turf_decal/tile/blue{
	dir = 1
	},
/obj/structure/table/glass,
/obj/machinery/computer/med_data/laptop{
	dir = 8
	},
/turf/open/floor/iron{
	heat_capacity = 1e+006
	},
/area/station/command/heads_quarters/cmo)
"q" = (
/obj/effect/turf_decal/tile/blue{
	dir = 1
	},
/turf/open/floor/iron{
	heat_capacity = 1e+006
	},
/area/station/command/heads_quarters/cmo)
"r" = (
/obj/effect/turf_decal/tile/blue{
	dir = 8
	},
/obj/effect/turf_decal/tile/blue{
	dir = 4
	},
/turf/open/floor/iron/white,
/area/station/command/heads_quarters/cmo)
"s" = (
/obj/machinery/door/airlock/command{
	name = "Chief Medical Officer's Office"
	},
/obj/effect/mapping_helpers/airlock/cyclelink_helper_multi{
	cycle_id = "CMO"
	},
/obj/effect/mapping_helpers/airlock/access/any/medical/cmo,
/turf/open/floor/iron{
	heat_capacity = 1e+006
	},
/area/station/command/heads_quarters/cmo)
"t" = (
/obj/effect/turf_decal/tile/blue{
	dir = 8
	},
/obj/effect/turf_decal/tile/blue{
	dir = 4
	},
/obj/machinery/atmospherics/pipe/smart/manifold4w/supply/hidden/layer4,
/turf/open/floor/iron/white,
/area/station/command/heads_quarters/cmo)
"v" = (
/obj/effect/turf_decal/tile/blue{
	dir = 1
	},
/obj/structure/table/glass,
/turf/open/floor/iron{
	heat_capacity = 1e+006
	},
/area/station/command/heads_quarters/cmo)
"w" = (
/obj/effect/turf_decal/tile/blue{
	dir = 8
	},
/obj/effect/turf_decal/tile/blue{
	dir = 4
	},
/obj/machinery/light/directional/east,
/obj/structure/disposalpipe/segment,
/turf/open/floor/iron/white,
/area/station/command/heads_quarters/cmo)
"x" = (
/obj/effect/turf_decal/tile/blue{
	dir = 1
	},
/obj/structure/table/glass,
/obj/item/folder/white,
/obj/item/clothing/neck/stethoscope,
/obj/machinery/firealarm/directional/west,
/turf/open/floor/iron{
	heat_capacity = 1e+006
	},
/area/station/command/heads_quarters/cmo)
"y" = (
/obj/effect/turf_decal/tile/blue{
	dir = 1
	},
/obj/structure/table/glass,
/obj/item/storage/medkit/regular,
/obj/item/folder/blue,
/turf/open/floor/iron{
	heat_capacity = 1e+006
	},
/area/station/command/heads_quarters/cmo)
"A" = (
/obj/effect/turf_decal/tile/blue{
	dir = 4
	},
/obj/effect/turf_decal/tile/blue{
	dir = 8
	},
/obj/machinery/keycard_auth/directional/south{
	pixel_x = 8;
	pixel_y = 32
	},
/obj/machinery/button/door/directional/south{
	id = "cmoshutter";
	name = "CMO Office Shutters";
	pixel_x = -7;
	pixel_y = 32;
	req_access_txt = "40"
	},
/turf/open/floor/iron/white,
/area/station/command/heads_quarters/cmo)
"B" = (
/obj/effect/turf_decal/tile/blue{
	dir = 8
	},
/obj/effect/turf_decal/tile/blue{
	dir = 4
	},
/obj/machinery/atmospherics/components/unary/vent_pump/on/layer4{
	dir = 1
	},
/turf/open/floor/iron/white,
/area/station/command/heads_quarters/cmo)
"C" = (
/obj/effect/spawner/structure/window/reinforced,
/obj/machinery/door/poddoor/shutters/preopen{
	id = "cmoshutter";
	name = "CMO Office Shutters"
	},
/turf/open/floor/plating,
/area/station/command/heads_quarters/cmo)
"D" = (
/obj/effect/turf_decal/tile/blue{
	dir = 4
	},
/obj/effect/turf_decal/tile/blue{
	dir = 8
	},
/obj/structure/chair/office/light,
/obj/effect/landmark/start/chief_medical_officer,
/turf/open/floor/iron/white,
/area/station/command/heads_quarters/cmo)
"E" = (
/obj/effect/turf_decal/tile/blue{
	dir = 8
	},
/obj/effect/turf_decal/tile/blue{
	dir = 4
	},
/obj/machinery/holopad,
/obj/effect/turf_decal/box/white{
	color = "#52B4E9"
	},
/obj/structure/disposalpipe/segment,
/turf/open/floor/iron/white,
/area/station/command/heads_quarters/cmo)
"F" = (
/obj/machinery/door/airlock/command{
	name = "Chief Medical Officer"
	},
/obj/machinery/atmospherics/pipe/smart/manifold4w/supply/hidden/layer4,
/obj/effect/mapping_helpers/airlock/cyclelink_helper_multi{
	cycle_id = "CMO"
	},
/obj/effect/mapping_helpers/airlock/access/any/medical/cmo,
/turf/open/floor/iron/dark,
/area/station/command/heads_quarters/cmo)
"H" = (
/obj/effect/turf_decal/tile/blue{
	dir = 1
	},
/obj/machinery/computer/crew{
	dir = 8
	},
/turf/open/floor/iron{
	heat_capacity = 1e+006
	},
/area/station/command/heads_quarters/cmo)
"I" = (
/obj/effect/mapping_helpers/airlock/cyclelink_helper_multi{
	cycle_id = "CMO"
	},
/obj/machinery/door/airlock/command{
	name = "Chief Medical Officer's Office"
	},
/obj/effect/mapping_helpers/airlock/access/any/medical/cmo,
/turf/open/floor/plating,
/area/station/command/heads_quarters/cmo)
"J" = (
/obj/effect/turf_decal/tile/blue{
	dir = 8
	},
/obj/effect/turf_decal/tile/blue{
	dir = 4
	},
/obj/machinery/atmospherics/components/unary/vent_scrubber/on/layer2{
	dir = 1
	},
/turf/open/floor/iron/white,
/area/station/command/heads_quarters/cmo)
"K" = (
/obj/machinery/atmospherics/pipe/smart/manifold4w/supply/hidden/layer4,
/turf/open/floor/iron/dark,
/area/station/command/heads_quarters/cmo)
"L" = (
/obj/effect/turf_decal/tile/blue{
	dir = 8
	},
/obj/effect/turf_decal/tile/blue{
	dir = 4
	},
/obj/structure/disposalpipe/segment,
/turf/open/floor/iron/white,
/area/station/command/heads_quarters/cmo)
"M" = (
/turf/open/floor/iron/dark,
/area/station/command/heads_quarters/cmo)
"N" = (
/obj/effect/turf_decal/tile/blue{
	dir = 1
	},
/obj/structure/table/glass,
/obj/item/clothing/neck/stethoscope,
/obj/item/clothing/glasses/hud/health,
/obj/machinery/airalarm/directional/west,
/turf/open/floor/iron{
	heat_capacity = 1e+006
	},
/area/station/command/heads_quarters/cmo)
"P" = (
/obj/effect/turf_decal/tile/blue{
	dir = 4
	},
/obj/effect/turf_decal/tile/blue{
	dir = 8
	},
/obj/structure/chair/comfy/lime{
	dir = 1
	},
/turf/open/floor/iron/white,
/area/station/command/heads_quarters/cmo)
"Q" = (
/obj/effect/turf_decal/tile/blue{
	dir = 4
	},
/obj/effect/turf_decal/tile/blue{
	dir = 8
	},
/obj/structure/table/glass,
/obj/item/folder/blue{
	pixel_x = 6;
	pixel_y = 6
	},
/obj/item/folder/white,
/obj/item/pen,
/turf/open/floor/iron/white,
/area/station/command/heads_quarters/cmo)
"R" = (
/obj/structure/closet/secure_closet/chief_medical,
/obj/machinery/newscaster/directional/east,
/turf/open/floor/iron/dark,
/area/station/command/heads_quarters/cmo)
"S" = (
/obj/effect/turf_decal/tile/blue{
	dir = 1
	},
/obj/item/kirbyplants/random,
/turf/open/floor/iron{
	heat_capacity = 1e+006
	},
/area/station/command/heads_quarters/cmo)
"U" = (
/obj/effect/turf_decal/tile/blue{
	dir = 1
	},
/obj/structure/bed/dogbed/runtime,
/mob/living/simple_animal/pet/cat/runtime,
/turf/open/floor/iron{
	heat_capacity = 1e+006
	},
/area/station/command/heads_quarters/cmo)
"V" = (
/obj/effect/turf_decal/tile/blue{
	dir = 4
	},
/obj/effect/turf_decal/tile/blue{
	dir = 8
	},
/obj/structure/table/glass,
/obj/item/paper_bin,
/obj/item/stamp/cmo,
/obj/machinery/atmospherics/pipe/smart/manifold4w/supply/hidden/layer4,
/turf/open/floor/iron/white,
/area/station/command/heads_quarters/cmo)
"W" = (
/obj/effect/turf_decal/tile/blue{
	dir = 8
	},
/obj/effect/turf_decal/tile/blue{
	dir = 4
	},
/obj/machinery/atmospherics/pipe/smart/manifold4w/supply/hidden/layer4,
/obj/machinery/atmospherics/pipe/smart/manifold4w/scrubbers/hidden/layer2,
/obj/structure/disposalpipe/segment,
/turf/open/floor/iron/white,
/area/station/command/heads_quarters/cmo)
"X" = (
/obj/machinery/atmospherics/components/unary/vent_pump/on/layer4{
	dir = 8
	},
/obj/machinery/light/directional/north,
/turf/open/floor/iron/dark,
/area/station/command/heads_quarters/cmo)
"Y" = (
/obj/effect/turf_decal/tile/blue{
	dir = 8
	},
/obj/effect/turf_decal/tile/blue{
	dir = 4
	},
/obj/item/toy/cattoy,
/obj/effect/landmark/start/chief_medical_officer,
/turf/open/floor/iron/white,
/area/station/command/heads_quarters/cmo)
"Z" = (
/obj/machinery/suit_storage_unit/cmo,
/turf/open/floor/iron/dark,
/area/station/command/heads_quarters/cmo)

(1,1,1) = {"
a
a
a
C
s
C
a
a
a
"}
(2,1,1) = {"
a
i
k
q
S
U
x
N
C
"}
(3,1,1) = {"
a
b
r
t
B
Y
r
y
C
"}
(4,1,1) = {"
f
c
W
W
E
L
w
h
C
"}
(5,1,1) = {"
C
e
r
n
J
a
a
a
a
"}
(6,1,1) = {"
C
v
A
V
l
F
K
Z
a
"}
(7,1,1) = {"
C
q
D
Q
P
a
X
M
a
"}
(8,1,1) = {"
a
m
H
o
q
a
R
g
a
"}
(9,1,1) = {"
a
a
C
C
I
a
a
a
a
"}
