//MAP CONVERTED BY dmm2tgm.py THIS HEADER COMMENT PREVENTS RECONVERSION, DO NOT REMOVE
"a" = (
/turf/closed/wall/r_wall,
/area/command/heads_quarters/cmo)
"b" = (
/obj/machinery/vending/drugs,
/turf/open/floor/iron/white/textured_large,
/area/medical/medbay/lobby)
"d" = (
/obj/effect/spawner/structure/window/reinforced,
/turf/open/floor/plating,
/area/command/heads_quarters/cmo)
"e" = (
/obj/effect/turf_decal/siding/blue{
	color = "#73c2fb";
	dir = 1;
	name = "medical blue"
	},
/obj/machinery/camera/directional/north{
	c_tag = "CMO";
	name = "CMO Camera";
	network = list("ss13","medbay")
	},
/obj/machinery/airalarm/directional/north,
/obj/structure/chair/office/light{
	dir = 8
	},
/turf/open/floor/iron/white,
/area/command/heads_quarters/cmo)
"f" = (
/obj/effect/turf_decal/siding/blue{
	color = "#73c2fb";
	dir = 8;
	name = "medical blue"
	},
/obj/machinery/door/airlock/command{
	name = "Chief Medical Officer's Office";
	req_access_txt = "40"
	},
/obj/machinery/atmospherics/pipe/smart/manifold4w/supply/hidden/layer4,
/obj/machinery/atmospherics/pipe/smart/manifold4w/scrubbers/hidden/layer2,
/obj/structure/cable,
/obj/effect/mapping_helpers/airlock/cyclelink_helper_multi{
	cycle_id = "CMO"
	},
/obj/modular_map_connector,
/obj/structure/disposalpipe/segment,
/turf/open/floor/iron/white,
/area/command/heads_quarters/cmo)
"g" = (
/obj/structure/closet/crate/freezer/blood,
/turf/open/floor/plating,
/area/maintenance/department/medical)
"h" = (
/obj/structure/closet/l3closet/virology,
/turf/open/floor/plating,
/area/maintenance/department/medical)
"i" = (
/obj/effect/turf_decal/siding/blue/corner{
	color = "#73c2fb";
	dir = 1;
	name = "medical blue"
	},
/obj/structure/cable,
/obj/machinery/atmospherics/pipe/smart/manifold4w/scrubbers/hidden/layer2,
/obj/machinery/atmospherics/pipe/smart/manifold4w/supply/hidden/layer4,
/turf/open/floor/iron/white,
/area/command/heads_quarters/cmo)
"k" = (
/obj/machinery/door/airlock/command{
	name = "Chief Medical Officer's Office";
	req_access_txt = "40"
	},
/obj/effect/turf_decal/siding/blue{
	color = "#73c2fb";
	name = "medical blue"
	},
/obj/effect/turf_decal/siding/blue{
	color = "#73c2fb";
	dir = 1;
	name = "medical blue"
	},
/obj/effect/mapping_helpers/airlock/cyclelink_helper_multi{
	cycle_id = "CMO-sidedoors"
	},
/turf/open/floor/iron/white,
/area/command/heads_quarters/cmo)
"l" = (
/obj/effect/turf_decal/siding/blue/corner{
	color = "#73c2fb";
	dir = 4;
	name = "medical blue"
	},
/obj/structure/disposalpipe/segment{
	dir = 4
	},
/turf/open/floor/iron/white,
/area/command/heads_quarters/cmo)
"m" = (
/obj/machinery/suit_storage_unit/cmo,
/obj/effect/turf_decal/siding/blue{
	color = "#73c2fb";
	dir = 5;
	name = "medical blue"
	},
/obj/machinery/light/directional/north,
/obj/machinery/button/door/directional/east{
	id = "cmoprivacy";
	name = "CMO Shutter Control";
	pixel_y = 6;
	req_access_txt = "40"
	},
/obj/machinery/requests_console/directional/north{
	announcementConsole = 1;
	department = "Chief Medical Officer's Desk";
	name = "Chief Medical Officer's Requests Console"
	},
/turf/open/floor/iron/white,
/area/command/heads_quarters/cmo)
"n" = (
/obj/machinery/holopad,
/obj/effect/turf_decal/box/white{
	color = "#52B4E9"
	},
/turf/open/floor/iron/white,
/area/command/heads_quarters/cmo)
"p" = (
/obj/effect/turf_decal/siding/blue{
	color = "#73c2fb";
	dir = 4;
	name = "medical blue"
	},
/obj/machinery/newscaster/directional/east,
/turf/open/floor/iron/white,
/area/command/heads_quarters/cmo)
"q" = (
/obj/effect/turf_decal/siding/blue{
	color = "#73c2fb";
	name = "medical blue"
	},
/obj/effect/turf_decal/siding/blue/corner{
	color = "#73c2fb";
	dir = 1;
	name = "medical blue"
	},
/turf/open/floor/iron/white,
/area/command/heads_quarters/cmo)
"r" = (
/obj/effect/turf_decal/siding/blue{
	color = "#73c2fb";
	name = "medical blue"
	},
/obj/item/radio/intercom/directional/south,
/turf/open/floor/iron/white,
/area/command/heads_quarters/cmo)
"s" = (
/obj/machinery/power/apc/auto_name/directional/south,
/obj/effect/turf_decal/siding/blue{
	color = "#73c2fb";
	name = "medical blue"
	},
/obj/machinery/atmospherics/components/unary/vent_scrubber/on/layer2{
	dir = 1
	},
/obj/structure/cable,
/turf/open/floor/iron/white,
/area/command/heads_quarters/cmo)
"u" = (
/obj/machinery/modular_computer/console/preset/id{
	dir = 4
	},
/obj/effect/turf_decal/siding/blue{
	color = "#73c2fb";
	dir = 9;
	name = "medical blue"
	},
/turf/open/floor/iron/white,
/area/command/heads_quarters/cmo)
"v" = (
/obj/machinery/firealarm/directional/north,
/obj/effect/turf_decal/siding/blue{
	color = "#73c2fb";
	dir = 1;
	name = "medical blue"
	},
/obj/machinery/disposal/bin,
/obj/structure/disposalpipe/trunk{
	dir = 8
	},
/turf/open/floor/iron/white,
/area/command/heads_quarters/cmo)
"w" = (
/obj/structure/table/glass,
/obj/item/cartridge/chemistry,
/obj/item/cartridge/medical,
/obj/item/cartridge/medical,
/obj/item/cartridge/medical,
/turf/open/floor/iron/white,
/area/maintenance/department/medical)
"x" = (
/turf/closed/wall/r_wall,
/area/maintenance/department/medical)
"y" = (
/obj/effect/turf_decal/tile/blue,
/obj/structure/table,
/obj/effect/spawner/random/food_or_drink/three_course_meal,
/turf/open/floor/iron,
/area/command/heads_quarters/cmo)
"z" = (
/obj/machinery/computer/med_data{
	dir = 4
	},
/obj/machinery/light/directional/west,
/obj/effect/turf_decal/siding/blue{
	color = "#73c2fb";
	dir = 8;
	name = "medical blue"
	},
/turf/open/floor/iron/white,
/area/command/heads_quarters/cmo)
"A" = (
/obj/machinery/atmospherics/components/unary/vent_pump/on/layer4{
	dir = 8
	},
/turf/open/floor/iron/white,
/area/command/heads_quarters/cmo)
"B" = (
/obj/effect/turf_decal/siding/blue{
	color = "#73c2fb";
	name = "medical blue"
	},
/obj/machinery/light/directional/south,
/obj/structure/bed/dogbed/runtime,
/mob/living/simple_animal/pet/cat/runtime,
/turf/open/floor/iron/white,
/area/command/heads_quarters/cmo)
"C" = (
/obj/effect/turf_decal/siding/blue{
	color = "#73c2fb";
	name = "medical blue"
	},
/obj/structure/table/glass,
/obj/item/paper_bin,
/obj/item/stamp/denied,
/obj/item/stamp/cmo,
/obj/item/pen,
/turf/open/floor/iron/white,
/area/command/heads_quarters/cmo)
"D" = (
/turf/open/floor/iron/white,
/area/command/heads_quarters/cmo)
"E" = (
/turf/closed/wall/r_wall,
/area/medical/medbay/lobby)
"F" = (
/obj/effect/landmark/start/chief_medical_officer,
/obj/machinery/atmospherics/pipe/smart/manifold4w/supply/hidden/layer4,
/turf/open/floor/iron/white,
/area/command/heads_quarters/cmo)
"G" = (
/turf/open/floor/plating,
/area/maintenance/department/medical)
"H" = (
/obj/machinery/keycard_auth{
	pixel_x = 25;
	pixel_y = 25
	},
/obj/effect/turf_decal/siding/blue{
	color = "#73c2fb";
	dir = 4;
	name = "medical blue"
	},
/obj/machinery/computer/security/telescreen/cmo{
	dir = 8;
	pixel_x = 27
	},
/turf/open/floor/iron/white,
/area/command/heads_quarters/cmo)
"I" = (
/obj/structure/cable,
/obj/machinery/atmospherics/pipe/smart/manifold4w/scrubbers/hidden/layer2,
/turf/open/floor/iron/white,
/area/command/heads_quarters/cmo)
"J" = (
/obj/effect/turf_decal/siding/blue/corner{
	color = "#73c2fb";
	name = "medical blue"
	},
/obj/effect/turf_decal/siding/blue/corner{
	color = "#73c2fb";
	dir = 8;
	name = "medical blue"
	},
/obj/item/toy/cattoy,
/turf/open/floor/iron/white,
/area/command/heads_quarters/cmo)
"K" = (
/obj/machinery/computer/crew{
	dir = 1
	},
/turf/open/floor/iron/white,
/area/maintenance/department/medical)
"L" = (
/obj/effect/turf_decal/siding/blue{
	color = "#73c2fb";
	name = "medical blue"
	},
/obj/effect/turf_decal/siding/blue/corner{
	color = "#73c2fb";
	dir = 4;
	name = "medical blue"
	},
/obj/structure/chair/office/light{
	dir = 8
	},
/obj/effect/landmark/start/chief_medical_officer,
/turf/open/floor/iron/white,
/area/command/heads_quarters/cmo)
"N" = (
/obj/structure/bloodsucker/bloodthrone/mundane,
/turf/open/floor/plating,
/area/maintenance/department/medical)
"O" = (
/obj/effect/turf_decal/siding/blue{
	color = "#73c2fb";
	dir = 4;
	name = "medical blue"
	},
/obj/machinery/door/airlock/command{
	name = "Chief Medical Officer's Office";
	req_access_txt = "40"
	},
/obj/effect/mapping_helpers/airlock/cyclelink_helper_multi{
	cycle_id = "CMO"
	},
/turf/open/floor/iron/white,
/area/command/heads_quarters/cmo)
"P" = (
/obj/effect/turf_decal/tile/blue,
/obj/structure/chair/comfy/black{
	dir = 8
	},
/turf/open/floor/iron,
/area/command/heads_quarters/cmo)
"Q" = (
/obj/structure/table/glass,
/obj/item/toy/figure/cmo,
/obj/item/clothing/neck/stethoscope,
/turf/open/floor/iron/white,
/area/command/heads_quarters/cmo)
"R" = (
/obj/effect/turf_decal/tile/blue{
	dir = 1
	},
/turf/open/floor/iron,
/area/command/heads_quarters/cmo)
"S" = (
/obj/machinery/door/airlock/command{
	name = "Chief Medical Officer's Office";
	req_access_txt = "40"
	},
/obj/effect/turf_decal/siding/blue{
	color = "#73c2fb";
	dir = 1;
	name = "medical blue"
	},
/obj/effect/turf_decal/siding/blue{
	color = "#73c2fb";
	name = "medical blue"
	},
/obj/effect/mapping_helpers/airlock/cyclelink_helper_multi{
	cycle_id = "CMO-sidedoors"
	},
/turf/open/floor/iron/white,
/area/command/heads_quarters/cmo)
"T" = (
/obj/structure/closet/secure_closet/chief_medical,
/obj/effect/turf_decal/siding/blue{
	color = "#73c2fb";
	dir = 1;
	name = "medical blue"
	},
/obj/machinery/light_switch/directional/north,
/turf/open/floor/iron/white,
/area/command/heads_quarters/cmo)
"U" = (
/obj/effect/turf_decal/siding/blue{
	color = "#73c2fb";
	dir = 4;
	name = "medical blue"
	},
/obj/effect/turf_decal/siding/blue{
	color = "#73c2fb";
	dir = 8;
	name = "medical blue"
	},
/obj/machinery/door/airlock/command{
	name = "Chief Medical Officer's Office";
	req_access_txt = "40"
	},
/obj/effect/mapping_helpers/airlock/cyclelink_helper_multi{
	cycle_id = "CMO"
	},
/turf/open/floor/iron/white,
/area/command/heads_quarters/cmo)
"W" = (
/obj/machinery/atmospherics/pipe/smart/manifold4w/supply/hidden/layer4,
/obj/machinery/atmospherics/pipe/smart/manifold4w/scrubbers/hidden/layer2,
/obj/structure/cable,
/obj/effect/turf_decal/siding/blue{
	color = "#73c2fb";
	dir = 8;
	name = "medical blue"
	},
/obj/structure/disposalpipe/segment{
	dir = 5
	},
/turf/open/floor/iron/white,
/area/command/heads_quarters/cmo)
"X" = (
/obj/effect/turf_decal/tile/blue{
	dir = 1
	},
/obj/effect/turf_decal/tile/blue,
/obj/structure/chair/comfy/black{
	dir = 4
	},
/turf/open/floor/iron,
/area/command/heads_quarters/cmo)
"Y" = (
/obj/effect/turf_decal/tile/blue,
/turf/open/floor/iron,
/area/command/heads_quarters/cmo)

(1,1,1) = {"
E
a
a
a
k
a
a
a
a
"}
(2,1,1) = {"
b
a
u
z
q
a
R
X
d
"}
(3,1,1) = {"
a
a
e
D
r
a
R
y
d
"}
(4,1,1) = {"
f
W
i
I
s
a
R
P
d
"}
(5,1,1) = {"
O
l
F
n
J
U
R
Y
d
"}
(6,1,1) = {"
a
v
A
D
B
x
x
x
x
"}
(7,1,1) = {"
a
T
D
Q
C
w
x
h
g
"}
(8,1,1) = {"
a
m
H
p
L
K
x
G
G
"}
(9,1,1) = {"
a
a
a
a
S
x
x
N
G
"}
