//MAP CONVERTED BY dmm2tgm.py THIS HEADER COMMENT PREVENTS RECONVERSION, DO NOT REMOVE
"a" = (
/turf/closed/wall/r_wall,
/area/station/command/heads_quarters/cmo)
"b" = (
/obj/machinery/door/airlock/maintenance{
	name = "Medbay Maintenance"
	},
/obj/effect/mapping_helpers/airlock/access/any/medical/general,
/turf/open/floor/plating,
/area/station/maintenance/department/medical)
"d" = (
/obj/effect/turf_decal/tile/blue{
	dir = 8
	},
/obj/effect/turf_decal/tile/blue{
	dir = 4
	},
/obj/machinery/atmospherics/pipe/smart/manifold4w/scrubbers/hidden/layer2,
/turf/open/floor/iron/white,
/area/station/command/heads_quarters/cmo)
"e" = (
/obj/effect/turf_decal/tile/blue{
	dir = 8
	},
/obj/effect/turf_decal/tile/blue{
	dir = 4
	},
/obj/structure/chair/comfy/black,
/turf/open/floor/iron/white,
/area/station/command/heads_quarters/cmo)
"f" = (
/turf/closed/wall,
/area/station/maintenance/department/medical)
"j" = (
/obj/effect/turf_decal/tile/blue{
	dir = 8
	},
/obj/effect/turf_decal/tile/blue{
	dir = 4
	},
/obj/machinery/atmospherics/pipe/smart/manifold4w/supply/hidden/layer4,
/turf/open/floor/iron/white,
/area/station/command/heads_quarters/cmo)
"k" = (
/obj/effect/turf_decal/tile/blue{
	dir = 8
	},
/obj/effect/turf_decal/tile/blue{
	dir = 4
	},
/obj/structure/chair/office{
	dir = 4
	},
/obj/effect/landmark/start/chief_medical_officer,
/turf/open/floor/iron/white,
/area/station/command/heads_quarters/cmo)
"l" = (
/obj/effect/turf_decal/tile/blue{
	dir = 1
	},
/obj/structure/table/glass,
/obj/machinery/firealarm/directional/west,
/obj/item/toy/figure/cmo,
/turf/open/floor/iron{
	heat_capacity = 1e+006
	},
/area/station/command/heads_quarters/cmo)
"m" = (
/obj/effect/turf_decal/tile/blue{
	dir = 1
	},
/obj/machinery/modular_computer/console/preset/id{
	dir = 8
	},
/obj/machinery/requests_console/directional/east{
	announcementConsole = 1;
	department = "Chief Medical Officer's Desk";
	name = "Chief Medical Officer's Requests Console"
	},
/turf/open/floor/iron{
	heat_capacity = 1e+006
	},
/area/station/command/heads_quarters/cmo)
"n" = (
/obj/effect/turf_decal/tile/blue{
	dir = 1
	},
/obj/machinery/light_switch/directional/north,
/obj/structure/cable,
/obj/structure/disposalpipe/segment{
	dir = 4
	},
/turf/open/floor/iron{
	heat_capacity = 1e+006
	},
/area/station/command/heads_quarters/cmo)
"p" = (
/obj/effect/turf_decal/tile/blue{
	dir = 1
	},
/obj/structure/table/glass,
/obj/item/folder/blue,
/obj/item/storage/medkit/regular,
/turf/open/floor/iron{
	heat_capacity = 1e+006
	},
/area/station/command/heads_quarters/cmo)
"q" = (
/obj/effect/turf_decal/tile/blue{
	dir = 1
	},
/obj/machinery/suit_storage_unit/cmo,
/turf/open/floor/iron{
	heat_capacity = 1e+006
	},
/area/station/command/heads_quarters/cmo)
"r" = (
/obj/effect/turf_decal/tile/blue{
	dir = 1
	},
/obj/machinery/disposal/bin,
/obj/machinery/newscaster/directional/west,
/obj/machinery/power/apc/auto_name/directional/north,
/obj/structure/cable,
/obj/structure/disposalpipe/trunk{
	dir = 4
	},
/turf/open/floor/iron{
	heat_capacity = 1e+006
	},
/area/station/command/heads_quarters/cmo)
"t" = (
/obj/effect/turf_decal/tile/blue{
	dir = 8
	},
/obj/effect/turf_decal/tile/blue{
	dir = 4
	},
/turf/open/floor/iron/white,
/area/station/command/heads_quarters/cmo)
"u" = (
/obj/machinery/door/airlock/command{
	name = "Chief Medical Officer's Office"
	},
/obj/effect/mapping_helpers/airlock/cyclelink_helper_multi{
	cycle_id = "CMO"
	},
/obj/structure/cable,
/obj/machinery/atmospherics/pipe/smart/manifold4w/supply/hidden/layer4,
/obj/machinery/atmospherics/pipe/smart/manifold4w/scrubbers/hidden/layer2,
/obj/modular_map_connector,
/obj/structure/disposalpipe/segment,
/obj/effect/mapping_helpers/airlock/access/any/medical/cmo,
/turf/open/floor/iron{
	heat_capacity = 1e+006
	},
/area/station/command/heads_quarters/cmo)
"w" = (
/obj/effect/turf_decal/tile/blue{
	dir = 1
	},
/obj/structure/cable,
/obj/machinery/atmospherics/pipe/smart/manifold4w/supply/hidden/layer4,
/obj/machinery/atmospherics/pipe/smart/manifold4w/scrubbers/hidden/layer2,
/obj/structure/disposalpipe/segment{
	dir = 9
	},
/turf/open/floor/iron{
	heat_capacity = 1e+006
	},
/area/station/command/heads_quarters/cmo)
"z" = (
/obj/effect/turf_decal/tile/blue{
	dir = 1
	},
/obj/structure/filingcabinet/chestdrawer,
/obj/machinery/button/door/directional/south{
	id = "cmoshutter";
	name = "CMO Office Shutters";
	pixel_x = -7;
	pixel_y = -25;
	req_access_txt = "40"
	},
/obj/machinery/keycard_auth/directional/south{
	pixel_x = 8;
	pixel_y = -25
	},
/obj/machinery/camera/directional/east{
	c_tag = "Medbay - Chief Medical Officer's Office";
	name = "medbay camera";
	network = list("ss13","medbay")
	},
/obj/machinery/computer/security/telescreen/cmo{
	dir = 8;
	pixel_x = 27
	},
/turf/open/floor/iron{
	heat_capacity = 1e+006
	},
/area/station/command/heads_quarters/cmo)
"A" = (
/obj/effect/spawner/structure/window/reinforced,
/obj/machinery/door/poddoor/shutters/preopen{
	id = "cmoshutter";
	name = "CMO Office Shutters"
	},
/turf/open/floor/plating,
/area/station/command/heads_quarters/cmo)
"B" = (
/obj/effect/turf_decal/tile/blue{
	dir = 1
	},
/obj/item/kirbyplants/random,
/turf/open/floor/iron{
	heat_capacity = 1e+006
	},
/area/station/command/heads_quarters/cmo)
"C" = (
/obj/effect/turf_decal/tile/blue{
	dir = 1
	},
/obj/structure/bed/dogbed/runtime,
/mob/living/simple_animal/pet/cat/runtime,
/turf/open/floor/iron{
	heat_capacity = 1e+006
	},
/area/station/command/heads_quarters/cmo)
"D" = (
/turf/closed/wall/r_wall,
/area/station/maintenance/department/medical)
"E" = (
/obj/effect/turf_decal/tile/blue{
	dir = 1
	},
/obj/structure/table/glass,
/obj/item/paper_bin,
/obj/machinery/light/directional/east,
/turf/open/floor/iron{
	heat_capacity = 1e+006
	},
/area/station/command/heads_quarters/cmo)
"F" = (
/obj/effect/turf_decal/tile/blue{
	dir = 8
	},
/obj/effect/turf_decal/tile/blue{
	dir = 4
	},
/obj/machinery/holopad,
/obj/effect/turf_decal/box/white{
	color = "#52B4E9"
	},
/turf/open/floor/iron/white,
/area/station/command/heads_quarters/cmo)
"G" = (
/obj/effect/turf_decal/tile/blue{
	dir = 1
	},
/obj/item/kirbyplants/random,
/obj/machinery/light/directional/north,
/turf/open/floor/iron{
	heat_capacity = 1e+006
	},
/area/station/command/heads_quarters/cmo)
"H" = (
/obj/effect/turf_decal/tile/blue{
	dir = 8
	},
/obj/effect/turf_decal/tile/blue{
	dir = 4
	},
/obj/machinery/atmospherics/pipe/smart/manifold4w/supply/hidden/layer4,
/obj/machinery/atmospherics/pipe/smart/manifold4w/scrubbers/hidden/layer2,
/turf/open/floor/iron/white,
/area/station/command/heads_quarters/cmo)
"J" = (
/obj/machinery/atmospherics/pipe/smart/manifold4w/supply/hidden/layer4,
/obj/machinery/atmospherics/pipe/smart/manifold4w/scrubbers/hidden/layer2,
/obj/structure/cable,
/turf/open/floor/plating,
/area/station/maintenance/department/medical)
"M" = (
/obj/effect/turf_decal/tile/blue{
	dir = 1
	},
/obj/structure/closet/secure_closet/chief_medical,
/turf/open/floor/iron{
	heat_capacity = 1e+006
	},
/area/station/command/heads_quarters/cmo)
"N" = (
/obj/effect/turf_decal/tile/blue{
	dir = 1
	},
/obj/structure/table/glass,
/obj/item/clothing/glasses/hud/health,
/turf/open/floor/iron{
	heat_capacity = 1e+006
	},
/area/station/command/heads_quarters/cmo)
"O" = (
/obj/machinery/door/airlock/command{
	name = "Chief Medical Officer's Office"
	},
/obj/effect/mapping_helpers/airlock/cyclelink_helper_multi{
	cycle_id = "CMO"
	},
/obj/effect/mapping_helpers/airlock/access/any/medical/cmo,
/turf/open/floor/iron{
	heat_capacity = 1e+006
	},
/area/station/command/heads_quarters/cmo)
"P" = (
/obj/effect/turf_decal/tile/blue{
	dir = 8
	},
/obj/effect/turf_decal/tile/blue{
	dir = 4
	},
/obj/machinery/atmospherics/components/unary/vent_pump/on/layer4{
	dir = 1
	},
/turf/open/floor/iron/white,
/area/station/command/heads_quarters/cmo)
"Q" = (
/obj/effect/turf_decal/tile/blue{
	dir = 8
	},
/obj/effect/turf_decal/tile/blue{
	dir = 4
	},
/obj/structure/table/glass,
/obj/item/stamp/cmo,
/turf/open/floor/iron/white,
/area/station/command/heads_quarters/cmo)
"R" = (
/obj/effect/turf_decal/tile/blue{
	dir = 8
	},
/obj/effect/turf_decal/tile/blue{
	dir = 4
	},
/obj/structure/table/glass,
/obj/item/folder/blue{
	pixel_x = 6;
	pixel_y = 6
	},
/obj/item/folder/white,
/obj/item/pen,
/turf/open/floor/iron/white,
/area/station/command/heads_quarters/cmo)
"S" = (
/obj/effect/turf_decal/tile/blue{
	dir = 1
	},
/turf/open/floor/iron{
	heat_capacity = 1e+006
	},
/area/station/command/heads_quarters/cmo)
"T" = (
/obj/machinery/door/airlock/maintenance{
	name = "Medbay Maintenance";
	req_access_txt = "5"
	},
/obj/machinery/atmospherics/pipe/smart/manifold4w/supply/hidden/layer4,
/obj/machinery/atmospherics/pipe/smart/manifold4w/scrubbers/hidden/layer2,
/obj/structure/cable,
/turf/open/floor/plating,
/area/station/maintenance/department/medical)
"U" = (
/obj/effect/turf_decal/tile/blue{
	dir = 8
	},
/obj/effect/turf_decal/tile/blue{
	dir = 4
	},
/obj/machinery/atmospherics/components/unary/vent_scrubber/on/layer2{
	dir = 1
	},
/obj/structure/chair/comfy/black,
/obj/effect/landmark/start/chief_medical_officer,
/turf/open/floor/iron/white,
/area/station/command/heads_quarters/cmo)
"V" = (
/obj/effect/mapping_helpers/airlock/cyclelink_helper_multi{
	cycle_id = "CMO"
	},
/obj/machinery/door/airlock/maintenance{
	name = "Chief Medical Office Maintenance"
	},
/obj/effect/mapping_helpers/airlock/access/any/medical/cmo,
/turf/open/floor/plating,
/area/station/maintenance/department/medical)
"W" = (
/obj/effect/turf_decal/tile/blue{
	dir = 1
	},
/obj/machinery/computer/crew{
	dir = 1
	},
/turf/open/floor/iron{
	heat_capacity = 1e+006
	},
/area/station/command/heads_quarters/cmo)
"X" = (
/obj/effect/turf_decal/tile/blue{
	dir = 1
	},
/obj/structure/table/glass,
/obj/machinery/computer/med_data/laptop{
	dir = 4;
	pixel_x = 3;
	pixel_y = 2
	},
/obj/item/radio/intercom/directional/west,
/turf/open/floor/iron{
	heat_capacity = 1e+006
	},
/area/station/command/heads_quarters/cmo)
"Z" = (
/obj/effect/turf_decal/tile/blue{
	dir = 1
	},
/obj/structure/table/glass,
/obj/item/folder/white,
/obj/item/clothing/neck/stethoscope,
/obj/machinery/airalarm/directional/north,
/turf/open/floor/iron{
	heat_capacity = 1e+006
	},
/area/station/command/heads_quarters/cmo)

(1,1,1) = {"
a
a
A
A
O
A
a
a
a
"}
(2,1,1) = {"
a
r
q
M
S
B
X
l
a
"}
(3,1,1) = {"
a
n
t
j
P
F
t
C
A
"}
(4,1,1) = {"
u
w
H
H
e
Q
t
W
A
"}
(5,1,1) = {"
a
G
t
d
U
R
k
S
A
"}
(6,1,1) = {"
a
Z
p
N
S
E
m
z
a
"}
(7,1,1) = {"
D
D
D
D
V
D
D
D
D
"}
(8,1,1) = {"
T
J
J
J
J
J
J
J
J
"}
(9,1,1) = {"
f
f
f
f
b
f
f
f
J
"}
