//MAP CONVERTED BY dmm2tgm.py THIS HEADER COMMENT PREVENTS RECONVERSION, DO NOT REMOVE
"a" = (
/turf/closed/wall,
/area/service/lawoffice)
"b" = (
/obj/structure/table/wood,
/obj/item/flashlight/lamp/green{
	pixel_x = -4;
	pixel_y = 11
	},
/obj/item/clothing/glasses/sunglasses,
/turf/open/floor/carpet/red,
/area/service/lawoffice)
"c" = (
/obj/structure/cable,
/obj/structure/disposalpipe/segment,
/turf/open/floor/carpet/red,
/area/service/lawoffice)
"d" = (
/obj/structure/table/wood,
/obj/item/paper_bin,
/obj/item/stamp/law,
/obj/item/pen/fountain{
	pixel_x = -5;
	pixel_y = 2
	},
/obj/item/reagent_containers/food/drinks/coffee{
	pixel_x = 8;
	pixel_y = 12
	},
/obj/item/pen/red,
/obj/structure/disposalpipe/segment{
	dir = 4
	},
/turf/open/floor/carpet/red,
/area/service/lawoffice)
"e" = (
/turf/open/floor/carpet/red,
/area/service/lawoffice)
"f" = (
/turf/open/floor/iron,
/area/hallway/primary/central/aft)
"g" = (
/obj/structure/bookcase,
/turf/open/floor/wood,
/area/service/lawoffice)
"h" = (
/obj/machinery/door/airlock/maintenance{
	name = "Prosecution Maintenance";
	req_access_txt = "38"
	},
/turf/open/floor/wood,
/area/service/lawoffice)
"i" = (
/obj/structure/cable,
/obj/machinery/atmospherics/components/unary/vent_scrubber/on/layer2{
	dir = 1
	},
/obj/structure/disposalpipe/segment,
/turf/open/floor/carpet/red,
/area/service/lawoffice)
"j" = (
/obj/structure/chair/comfy/lime{
	dir = 8
	},
/obj/effect/landmark/start/lawyer,
/turf/open/floor/wood,
/area/service/lawoffice)
"k" = (
/obj/machinery/door/poddoor/preopen{
	id = "law3";
	name = "Law Office Shared Privacy Door"
	},
/obj/effect/spawner/structure/window/reinforced,
/obj/structure/disposalpipe/segment{
	dir = 4
	},
/turf/open/floor/plating,
/area/service/lawoffice)
"l" = (
/obj/machinery/atmospherics/pipe/smart/manifold4w/supply/hidden/layer4,
/obj/structure/filingcabinet/chestdrawer/wheeled,
/turf/open/floor/wood,
/area/service/lawoffice)
"n" = (
/obj/machinery/door/poddoor/preopen{
	id = "law3";
	name = "Law Office Shared Privacy Door"
	},
/obj/effect/spawner/structure/window/reinforced,
/turf/open/floor/plating,
/area/service/lawoffice)
"o" = (
/obj/machinery/door/firedoor,
/obj/machinery/door/airlock/glass_large{
	name = "Public Defenders";
	req_access = "38"
	},
/turf/open/floor/carpet/red,
/area/service/lawoffice)
"p" = (
/obj/structure/table/wood,
/obj/item/paper_bin,
/obj/item/stamp/law,
/obj/item/pen,
/turf/open/floor/carpet/red,
/area/service/lawoffice)
"q" = (
/obj/machinery/vending/wardrobe/law_wardrobe,
/turf/open/floor/wood,
/area/service/lawoffice)
"r" = (
/obj/item/storage/briefcase/lawyer,
/obj/structure/rack,
/obj/item/storage/secure/briefcase,
/obj/item/clothing/glasses/sunglasses/big,
/obj/machinery/light/directional/south,
/turf/open/floor/wood,
/area/service/lawoffice)
"s" = (
/obj/machinery/photocopier,
/turf/open/floor/wood,
/area/service/lawoffice)
"t" = (
/obj/structure/chair/comfy/lime{
	dir = 4
	},
/turf/open/floor/carpet/red,
/area/service/lawoffice)
"u" = (
/obj/machinery/airalarm/directional/south,
/obj/machinery/camera/directional/south{
	c_tag = "Law Office";
	name = "Law Office Camera"
	},
/turf/open/floor/wood,
/area/service/lawoffice)
"v" = (
/obj/modular_map_connector,
/turf/open/floor/iron,
/area/hallway/primary/central/aft)
"w" = (
/turf/closed/wall/r_wall,
/area/service/lawoffice)
"x" = (
/obj/structure/disposalpipe/segment{
	dir = 4
	},
/turf/open/floor/wood,
/area/service/lawoffice)
"y" = (
/obj/structure/sign/directions/medical{
	dir = 1
	},
/obj/structure/sign/directions/science{
	dir = 8;
	pixel_y = -8
	},
/obj/structure/sign/directions/supply{
	dir = 8;
	pixel_y = 8
	},
/turf/closed/wall,
/area/service/lawoffice)
"z" = (
/obj/structure/cable,
/obj/machinery/atmospherics/pipe/smart/manifold4w/scrubbers/hidden/layer2,
/obj/machinery/atmospherics/pipe/smart/manifold4w/supply/hidden/layer4,
/obj/machinery/door/firedoor,
/obj/structure/disposalpipe/segment,
/turf/open/floor/carpet/red,
/area/service/lawoffice)
"A" = (
/turf/open/floor/wood,
/area/service/lawoffice)
"B" = (
/obj/machinery/light/directional/west,
/turf/open/floor/wood,
/area/service/lawoffice)
"D" = (
/obj/structure/cable,
/obj/structure/disposalpipe/segment{
	dir = 5
	},
/turf/open/floor/carpet/red,
/area/service/lawoffice)
"F" = (
/obj/machinery/atmospherics/components/unary/vent_pump/on/layer4{
	dir = 1
	},
/turf/open/floor/carpet/red,
/area/service/lawoffice)
"G" = (
/obj/machinery/atmospherics/pipe/smart/manifold4w/supply/hidden/layer4,
/obj/machinery/atmospherics/pipe/smart/manifold4w/scrubbers/hidden/layer2,
/obj/structure/cable,
/obj/structure/disposalpipe/segment,
/turf/open/floor/iron,
/area/hallway/primary/central/aft)
"H" = (
/obj/structure/cable,
/obj/structure/chair/comfy/black{
	dir = 8
	},
/turf/open/floor/carpet/red,
/area/service/lawoffice)
"I" = (
/obj/structure/cable,
/obj/machinery/atmospherics/pipe/smart/manifold4w/scrubbers/hidden/layer2,
/obj/machinery/atmospherics/pipe/smart/manifold4w/supply/hidden/layer4,
/obj/structure/disposalpipe/segment,
/turf/open/floor/carpet/red,
/area/service/lawoffice)
"J" = (
/obj/structure/table/wood,
/obj/item/book/manual/wiki/security_space_law,
/obj/item/taperecorder,
/obj/item/book/manual/wiki/security_space_law,
/turf/open/floor/carpet/red,
/area/service/lawoffice)
"K" = (
/obj/machinery/requests_console/directional/south{
	department = "Law Office";
	name = "Law Office Requests Console"
	},
/obj/machinery/disposal/bin,
/obj/structure/disposalpipe/trunk{
	dir = 1
	},
/turf/open/floor/wood,
/area/service/lawoffice)
"M" = (
/obj/machinery/atmospherics/components/unary/vent_scrubber/on/layer2{
	dir = 1
	},
/turf/open/floor/iron,
/area/hallway/primary/central/aft)
"N" = (
/obj/structure/table/wood,
/obj/item/storage/secure/briefcase,
/obj/item/taperecorder,
/obj/item/book/manual/wiki/security_space_law,
/turf/open/floor/wood,
/area/service/lawoffice)
"O" = (
/obj/machinery/camera/directional/north{
	c_tag = "Law Office";
	name = "Law Office Camera"
	},
/obj/item/kirbyplants/random,
/turf/open/floor/wood,
/area/service/lawoffice)
"P" = (
/obj/machinery/button/door/directional/south{
	id = "law3";
	name = "Public Defender Privacy";
	pixel_x = -24;
	pixel_y = 0;
	req_access_txt = "38"
	},
/turf/closed/wall,
/area/service/lawoffice)
"Q" = (
/obj/machinery/light/directional/east,
/turf/open/floor/wood,
/area/service/lawoffice)
"R" = (
/obj/structure/cable,
/turf/open/floor/carpet/red,
/area/service/lawoffice)
"S" = (
/obj/machinery/light_switch/directional/south,
/obj/machinery/disposal/bin,
/obj/structure/disposalpipe/trunk{
	dir = 1
	},
/turf/open/floor/wood,
/area/service/lawoffice)
"T" = (
/obj/structure/disposalpipe/segment{
	dir = 10
	},
/turf/open/floor/carpet/red,
/area/service/lawoffice)
"U" = (
/obj/structure/cable,
/obj/machinery/power/apc/auto_name/directional/south,
/obj/item/kirbyplants/random,
/turf/open/floor/wood,
/area/service/lawoffice)
"V" = (
/obj/item/kirbyplants/random,
/turf/open/floor/wood,
/area/service/lawoffice)
"W" = (
/obj/item/flashlight/lamp,
/obj/structure/table/wood,
/obj/item/clothing/glasses/sunglasses,
/turf/open/floor/wood,
/area/service/lawoffice)
"X" = (
/obj/structure/chair/comfy/black{
	dir = 8
	},
/obj/structure/disposalpipe/segment{
	dir = 4
	},
/turf/open/floor/carpet/red,
/area/service/lawoffice)
"Z" = (
/obj/structure/chair/comfy/black{
	dir = 4
	},
/obj/effect/landmark/start/lawyer,
/turf/open/floor/wood,
/area/service/lawoffice)

(1,1,1) = {"
f
a
a
k
n
a
a
"}
(2,1,1) = {"
f
a
B
x
Z
B
a
"}
(3,1,1) = {"
f
a
A
d
b
N
a
"}
(4,1,1) = {"
f
P
O
X
H
U
a
"}
(5,1,1) = {"
f
n
g
T
c
K
a
"}
(6,1,1) = {"
f
n
s
e
R
A
h
"}
(7,1,1) = {"
v
o
e
e
R
q
a
"}
(8,1,1) = {"
G
z
I
i
D
r
a
"}
(9,1,1) = {"
f
n
l
F
T
S
a
"}
(10,1,1) = {"
f
n
g
e
e
u
a
"}
(11,1,1) = {"
f
a
V
t
t
V
a
"}
(12,1,1) = {"
f
P
A
p
J
W
a
"}
(13,1,1) = {"
f
y
Q
A
j
Q
a
"}
(14,1,1) = {"
M
w
w
w
w
w
w
"}
