//MAP CONVERTED BY dmm2tgm.py THIS HEADER COMMENT PREVENTS RECONVERSION, DO NOT REMOVE
"a" = (
/turf/closed/wall,
/area/station/service/lawoffice)
"b" = (
/obj/machinery/power/apc/auto_name/directional/south,
/obj/machinery/atmospherics/pipe/smart/manifold4w/supply/hidden/layer4,
/obj/machinery/atmospherics/components/unary/vent_scrubber/on/layer2{
	dir = 8
	},
/obj/structure/cable,
/obj/structure/disposalpipe/segment{
	dir = 4
	},
/turf/open/floor/wood,
/area/station/service/lawoffice)
"c" = (
/obj/machinery/door/poddoor/preopen{
	id = "Prosecution1";
	name = "Prosecution Office Privacy"
	},
/obj/effect/spawner/structure/window/reinforced,
/turf/open/floor/plating,
/area/station/service/lawoffice)
"d" = (
/obj/machinery/atmospherics/pipe/smart/manifold4w/supply/hidden/layer4,
/obj/machinery/atmospherics/pipe/smart/manifold4w/scrubbers/hidden/layer2,
/obj/structure/cable,
/obj/machinery/light/directional/south,
/obj/machinery/newscaster/directional/south,
/obj/structure/disposalpipe/segment{
	dir = 4
	},
/turf/open/floor/wood,
/area/station/service/lawoffice)
"e" = (
/obj/machinery/door/airlock{
	name = "Prosecution Office"
	},
/obj/machinery/door/firedoor,
/obj/machinery/atmospherics/pipe/smart/manifold4w/supply/hidden/layer4,
/obj/machinery/atmospherics/pipe/smart/manifold4w/scrubbers/hidden/layer2,
/obj/structure/cable,
/obj/structure/disposalpipe/segment{
	dir = 4
	},
/obj/effect/mapping_helpers/airlock/access/any/service/lawyer,
/turf/open/floor/iron/dark,
/area/station/service/lawoffice)
"f" = (
/obj/machinery/atmospherics/components/unary/vent_pump/on/layer4{
	dir = 8
	},
/obj/structure/disposalpipe/segment{
	dir = 9
	},
/turf/open/floor/wood,
/area/station/service/lawoffice)
"g" = (
/obj/machinery/atmospherics/pipe/smart/manifold4w/supply/hidden/layer4,
/obj/machinery/atmospherics/pipe/smart/manifold4w/scrubbers/hidden/layer2,
/obj/structure/cable,
/turf/open/floor/wood,
/area/service/lawoffice/upper)
"h" = (
/obj/structure/rack,
/obj/item/storage/briefcase,
/obj/item/taperecorder,
/obj/item/clothing/glasses/sunglasses,
/obj/machinery/camera/directional/north{
	c_tag = "Law Office";
	name = "Law Office Camera"
	},
/turf/open/floor/carpet/blue,
/area/station/service/lawoffice)
"i" = (
/obj/machinery/door/poddoor/preopen{
	id = "law3";
	name = "Law Office Shared Privacy Door"
	},
/obj/effect/spawner/structure/window/reinforced,
/turf/open/floor/plating,
/area/service/lawoffice/upper)
"j" = (
/obj/machinery/button/door/directional/south{
	id = "law3";
	name = "Public Defender Privacy";
	pixel_x = -24;
	pixel_y = 0;
	req_access_txt = "38"
	},
/obj/machinery/atmospherics/pipe/smart/manifold4w/supply/hidden/layer4,
/obj/machinery/atmospherics/pipe/smart/manifold4w/scrubbers/hidden/layer2,
/obj/structure/cable,
/obj/structure/disposalpipe/segment,
/turf/open/floor/wood,
/area/service/lawoffice/upper)
"k" = (
/obj/machinery/door/airlock/maintenance{
	name = "Public Defender Maintenance"
	},
/obj/effect/mapping_helpers/airlock/access/any/service/lawyer,
/turf/open/floor/wood,
/area/service/lawoffice/upper)
"l" = (
/obj/structure/filingcabinet/chestdrawer/wheeled,
/turf/open/floor/wood,
/area/station/service/lawoffice)
"m" = (
/obj/machinery/power/apc/auto_name/directional/south,
/obj/structure/cable,
/obj/machinery/camera/directional/south{
	c_tag = "Law Office";
	name = "Law Office Camera"
	},
/turf/open/floor/carpet/purple,
/area/service/lawoffice/upper)
"n" = (
/obj/machinery/disposal/bin,
/obj/structure/disposalpipe/trunk{
	dir = 8
	},
/turf/open/floor/wood,
/area/station/service/lawoffice)
"o" = (
/obj/structure/chair/comfy/black,
/obj/effect/landmark/start/lawyer,
/turf/open/floor/carpet/blue,
/area/station/service/lawoffice)
"p" = (
/obj/item/flashlight/lamp,
/obj/structure/table/wood,
/obj/item/clothing/glasses/sunglasses,
/turf/open/floor/carpet/purple,
/area/service/lawoffice/upper)
"q" = (
/obj/machinery/requests_console/directional/south{
	department = "Law Office";
	name = "Law Office Requests Console"
	},
/obj/machinery/atmospherics/pipe/smart/manifold4w/supply/hidden/layer4,
/obj/machinery/atmospherics/pipe/smart/manifold4w/scrubbers/hidden/layer2,
/obj/structure/cable,
/obj/structure/disposalpipe/segment{
	dir = 4
	},
/turf/open/floor/wood,
/area/station/service/lawoffice)
"r" = (
/obj/structure/table/wood,
/obj/item/paper_bin,
/obj/item/stamp/law,
/obj/item/pen,
/obj/item/storage/briefcase/lawyer,
/turf/open/floor/carpet/purple,
/area/service/lawoffice/upper)
"s" = (
/turf/closed/wall,
/area/service/lawoffice/upper)
"t" = (
/obj/machinery/photocopier,
/obj/machinery/light_switch/directional/north,
/turf/open/floor/carpet/blue,
/area/station/service/lawoffice)
"u" = (
/obj/structure/disposalpipe/segment,
/turf/open/floor/wood,
/area/service/lawoffice/upper)
"v" = (
/turf/open/floor/carpet/blue,
/area/station/service/lawoffice)
"w" = (
/obj/structure/chair/wood{
	dir = 1
	},
/obj/machinery/requests_console/directional/south{
	department = "Law Office";
	name = "Law Office Requests Console"
	},
/obj/effect/landmark/start/lawyer,
/turf/open/floor/carpet/purple,
/area/service/lawoffice/upper)
"x" = (
/turf/open/floor/iron,
/area/station/hallway/primary/central/aft)
"y" = (
/obj/machinery/airalarm/directional/south,
/obj/machinery/atmospherics/pipe/smart/manifold4w/supply/hidden/layer4,
/obj/machinery/atmospherics/pipe/smart/manifold4w/scrubbers/hidden/layer2,
/obj/structure/cable,
/obj/structure/disposalpipe/segment{
	dir = 4
	},
/turf/open/floor/wood,
/area/station/service/lawoffice)
"z" = (
/obj/machinery/photocopier,
/obj/item/radio/intercom/directional/south,
/obj/machinery/light_switch/directional/east,
/turf/open/floor/carpet/purple,
/area/service/lawoffice/upper)
"A" = (
/obj/structure/chair/comfy/black{
	dir = 1
	},
/turf/open/floor/carpet/blue,
/area/station/service/lawoffice)
"B" = (
/obj/effect/spawner/structure/window,
/turf/open/floor/plating,
/area/service/lawoffice/upper)
"C" = (
/obj/structure/chair/wood,
/obj/machinery/light/directional/east,
/turf/open/floor/carpet/purple,
/area/service/lawoffice/upper)
"D" = (
/obj/item/kirbyplants/random,
/turf/open/floor/wood,
/area/station/service/lawoffice)
"E" = (
/obj/structure/disposalpipe/segment{
	dir = 6
	},
/turf/open/floor/carpet/blue,
/area/station/service/lawoffice)
"F" = (
/obj/structure/table/wood,
/obj/item/book/manual/wiki/security_space_law,
/obj/item/taperecorder,
/turf/open/floor/carpet/purple,
/area/service/lawoffice/upper)
"G" = (
/obj/machinery/disposal/bin,
/obj/machinery/light/directional/south,
/obj/structure/disposalpipe/trunk{
	dir = 1
	},
/turf/open/floor/wood,
/area/service/lawoffice/upper)
"H" = (
/obj/machinery/atmospherics/pipe/smart/manifold4w/supply/hidden/layer4,
/obj/machinery/atmospherics/pipe/smart/manifold4w/scrubbers/hidden/layer2,
/obj/structure/cable,
/obj/structure/disposalpipe/segment,
/turf/open/floor/iron,
/area/station/hallway/primary/central/aft)
"I" = (
/obj/machinery/atmospherics/components/unary/vent_pump/on/layer4{
	dir = 8
	},
/obj/machinery/airalarm/directional/north,
/obj/machinery/atmospherics/pipe/smart/manifold4w/scrubbers/hidden/layer2,
/turf/open/floor/wood,
/area/service/lawoffice/upper)
"J" = (
/obj/structure/chair/wood,
/turf/open/floor/carpet/purple,
/area/service/lawoffice/upper)
"K" = (
/obj/structure/filingcabinet/employment,
/obj/structure/disposalpipe/segment,
/turf/open/floor/wood,
/area/service/lawoffice/upper)
"L" = (
/obj/structure/disposalpipe/segment,
/turf/open/floor/carpet/blue,
/area/station/service/lawoffice)
"M" = (
/obj/structure/sign/directions/medical{
	dir = 1
	},
/obj/structure/sign/directions/science{
	dir = 8;
	pixel_y = -8
	},
/obj/structure/sign/directions/supply{
	dir = 8;
	pixel_y = 8
	},
/turf/closed/wall,
/area/service/lawoffice/upper)
"N" = (
/obj/machinery/door/airlock/maintenance{
	name = "Prosecution Maintenance"
	},
/obj/effect/mapping_helpers/airlock/access/any/service/lawyer,
/turf/open/floor/wood,
/area/station/service/lawoffice)
"O" = (
/obj/machinery/atmospherics/components/unary/vent_scrubber/on/layer2{
	dir = 1
	},
/obj/structure/disposalpipe/segment{
	dir = 5
	},
/turf/open/floor/iron,
/area/station/hallway/primary/central/aft)
"P" = (
/turf/open/floor/carpet/purple,
/area/service/lawoffice/upper)
"Q" = (
/obj/structure/table/wood,
/obj/item/book/manual/wiki/security_space_law,
/turf/open/floor/carpet/blue,
/area/station/service/lawoffice)
"R" = (
/obj/machinery/button/door/directional/north{
	id = "Prosecution1";
	name = "Prosecution Office Privacy";
	pixel_x = 25;
	pixel_y = 0;
	req_access_txt = "38"
	},
/obj/machinery/light/directional/north,
/turf/open/floor/wood,
/area/station/service/lawoffice)
"S" = (
/obj/machinery/door/airlock{
	name = "Public Defenders Office"
	},
/obj/machinery/door/firedoor,
/obj/machinery/atmospherics/pipe/smart/manifold4w/supply/hidden/layer4,
/obj/machinery/atmospherics/pipe/smart/manifold4w/scrubbers/hidden/layer2,
/obj/structure/cable,
/obj/structure/disposalpipe/segment,
/obj/effect/landmark/navigate_destination/lawyer,
/obj/effect/mapping_helpers/airlock/access/any/service/lawyer,
/turf/open/floor/iron,
/area/service/lawoffice/upper)
"T" = (
/obj/modular_map_connector,
/turf/open/floor/iron,
/area/station/hallway/primary/central/aft)
"U" = (
/obj/item/kirbyplants/random,
/obj/machinery/atmospherics/components/unary/vent_scrubber/on/layer2{
	dir = 8
	},
/turf/open/floor/wood,
/area/service/lawoffice/upper)
"V" = (
/obj/structure/table/wood,
/obj/item/flashlight/lamp/green{
	pixel_x = 1;
	pixel_y = 5
	},
/turf/open/floor/carpet/blue,
/area/station/service/lawoffice)
"W" = (
/turf/closed/wall/r_wall,
/area/service/lawoffice/upper)
"X" = (
/obj/machinery/atmospherics/pipe/smart/manifold4w/supply/hidden/layer4,
/obj/machinery/vending/wardrobe/law_wardrobe,
/obj/machinery/atmospherics/pipe/smart/manifold4w/scrubbers/hidden/layer2,
/turf/open/floor/wood,
/area/service/lawoffice/upper)
"Y" = (
/obj/structure/table/wood,
/obj/item/toy/figure/lawyer,
/turf/open/floor/carpet/blue,
/area/station/service/lawoffice)
"Z" = (
/obj/structure/cable,
/turf/open/floor/carpet/purple,
/area/service/lawoffice/upper)

(1,1,1) = {"
x
a
a
c
c
e
a
"}
(2,1,1) = {"
x
a
h
v
v
d
a
"}
(3,1,1) = {"
x
a
t
V
v
y
a
"}
(4,1,1) = {"
x
a
o
Q
A
q
a
"}
(5,1,1) = {"
x
c
v
Y
A
b
a
"}
(6,1,1) = {"
x
c
v
E
L
f
N
"}
(7,1,1) = {"
T
a
R
n
l
D
a
"}
(8,1,1) = {"
x
s
s
B
B
B
s
"}
(9,1,1) = {"
H
S
j
u
K
G
s
"}
(10,1,1) = {"
x
i
g
Z
Z
Z
k
"}
(11,1,1) = {"
x
i
X
P
p
m
s
"}
(12,1,1) = {"
x
s
I
J
F
w
s
"}
(13,1,1) = {"
x
M
U
C
r
z
s
"}
(14,1,1) = {"
O
W
W
W
W
W
W
"}
