//MAP CONVERTED BY dmm2tgm.py THIS HEADER COMMENT PREVENTS RECONVERSION, DO NOT REMOVE
"cN" = (
/obj/structure/cable,
/obj/item/radio/intercom/directional/east,
/obj/structure/disposalpipe/segment{
	dir = 9
	},
/turf/open/floor/carpet/red,
/area/service/lawoffice)
"de" = (
/obj/machinery/light_switch/directional/north,
/turf/open/floor/iron/grimy,
/area/service/lawoffice/upper)
"gB" = (
/obj/machinery/atmospherics/pipe/smart/manifold4w/supply/hidden/layer4,
/turf/open/floor/iron/grimy,
/area/service/lawoffice/upper)
"hm" = (
/obj/structure/filingcabinet/employment,
/turf/open/floor/carpet/red,
/area/service/lawoffice)
"hq" = (
/obj/machinery/light_switch/directional/south,
/obj/machinery/camera/directional/south{
	c_tag = "Law Office";
	name = "Law Office Camera"
	},
/turf/open/floor/wood,
/area/service/lawoffice/upper)
"iq" = (
/obj/item/kirbyplants/random,
/turf/open/floor/wood,
/area/service/lawoffice/upper)
"kg" = (
/obj/machinery/power/apc/auto_name/directional/south,
/obj/structure/cable,
/obj/structure/disposalpipe/segment{
	dir = 4
	},
/turf/open/floor/carpet/red,
/area/service/lawoffice)
"km" = (
/obj/structure/table/wood,
/obj/item/book/manual/wiki/security_space_law,
/turf/open/floor/carpet/red,
/area/service/lawoffice)
"kw" = (
/obj/structure/cable,
/obj/structure/disposalpipe/segment{
	dir = 9
	},
/turf/open/floor/iron/grimy,
/area/service/lawoffice/upper)
"la" = (
/obj/machinery/door/airlock{
	name = "Prosecution Office";
	req_access_txt = "38"
	},
/obj/machinery/door/firedoor,
/obj/machinery/atmospherics/pipe/smart/manifold4w/supply/hidden/layer4,
/obj/machinery/atmospherics/pipe/smart/manifold4w/scrubbers/hidden/layer2,
/obj/structure/cable,
/obj/structure/disposalpipe/segment{
	dir = 4
	},
/turf/open/floor/iron/dark,
/area/service/lawoffice)
"mV" = (
/obj/machinery/atmospherics/pipe/smart/manifold4w/supply/hidden/layer4,
/obj/machinery/atmospherics/pipe/smart/manifold4w/scrubbers/hidden/layer2,
/obj/structure/cable,
/obj/structure/disposalpipe/segment,
/turf/open/floor/iron,
/area/hallway/primary/central/aft)
"oF" = (
/obj/machinery/door/airlock{
	name = "Public Defenders Office";
	req_access_txt = "38"
	},
/obj/machinery/door/firedoor,
/obj/machinery/atmospherics/pipe/smart/manifold4w/supply/hidden/layer4,
/obj/machinery/atmospherics/pipe/smart/manifold4w/scrubbers/hidden/layer2,
/obj/structure/cable,
/obj/structure/disposalpipe/segment,
/obj/effect/landmark/navigate_destination/lawyer,
/turf/open/floor/iron,
/area/service/lawoffice/upper)
"pk" = (
/turf/closed/wall,
/area/service/lawoffice)
"qz" = (
/obj/machinery/button/door/directional/south{
	id = "law3";
	name = "Public Defender Privacy";
	pixel_x = -24;
	pixel_y = 0;
	req_access_txt = "38"
	},
/obj/machinery/disposal/bin,
/obj/structure/disposalpipe/trunk{
	dir = 4
	},
/turf/open/floor/wood,
/area/service/lawoffice/upper)
"te" = (
/turf/open/floor/iron/grimy,
/area/service/lawoffice/upper)
"tV" = (
/obj/structure/table/wood,
/obj/item/flashlight/lamp/green{
	pixel_x = -4;
	pixel_y = 11
	},
/obj/item/clothing/glasses/sunglasses,
/turf/open/floor/carpet/red,
/area/service/lawoffice)
"ui" = (
/obj/machinery/door/airlock/maintenance{
	name = "Prosecution Maintenance";
	req_access_txt = "38"
	},
/turf/open/floor/carpet/red,
/area/service/lawoffice)
"vV" = (
/obj/structure/table/wood,
/obj/item/paper_bin,
/obj/item/stamp/law,
/obj/item/pen/fountain{
	pixel_x = -5;
	pixel_y = 2
	},
/obj/item/reagent_containers/food/drinks/coffee{
	pixel_x = 8;
	pixel_y = 12
	},
/obj/item/pen/red,
/turf/open/floor/carpet/red,
/area/service/lawoffice)
"wD" = (
/obj/machinery/atmospherics/pipe/smart/manifold4w/scrubbers/hidden/layer2,
/obj/structure/cable,
/obj/machinery/atmospherics/components/unary/vent_pump/on/layer4{
	dir = 8
	},
/turf/open/floor/carpet/red,
/area/service/lawoffice)
"xb" = (
/obj/structure/chair/comfy/lime{
	dir = 1
	},
/obj/effect/landmark/start/lawyer,
/obj/machinery/requests_console/directional/south{
	department = "Law Office";
	name = "Law Office Requests Console"
	},
/turf/open/floor/wood,
/area/service/lawoffice/upper)
"xv" = (
/turf/closed/wall,
/area/service/lawoffice/upper)
"xR" = (
/obj/machinery/atmospherics/pipe/smart/manifold4w/scrubbers/hidden/layer2,
/obj/structure/chair/comfy/black,
/obj/structure/cable,
/obj/effect/landmark/start/lawyer,
/turf/open/floor/carpet/red,
/area/service/lawoffice)
"yb" = (
/obj/item/kirbyplants{
	icon_state = "plant-10"
	},
/obj/machinery/airalarm/directional/south,
/obj/structure/cable,
/obj/machinery/atmospherics/pipe/smart/manifold4w/supply/hidden/layer4,
/obj/machinery/atmospherics/pipe/smart/manifold4w/scrubbers/hidden/layer2,
/obj/structure/disposalpipe/segment{
	dir = 4
	},
/turf/open/floor/carpet/red,
/area/service/lawoffice)
"yC" = (
/obj/machinery/atmospherics/components/unary/vent_scrubber/on/layer2{
	dir = 8
	},
/obj/structure/cable,
/obj/structure/disposalpipe/segment,
/turf/open/floor/carpet/red,
/area/service/lawoffice)
"AB" = (
/obj/item/storage/briefcase/lawyer,
/obj/structure/rack,
/obj/item/storage/secure/briefcase,
/obj/item/clothing/glasses/sunglasses/big,
/turf/open/floor/wood,
/area/service/lawoffice/upper)
"Bx" = (
/obj/machinery/atmospherics/components/unary/vent_scrubber/on/layer2{
	dir = 1
	},
/obj/structure/cable,
/obj/structure/disposalpipe/segment,
/turf/open/floor/iron/grimy,
/area/service/lawoffice/upper)
"DM" = (
/turf/open/floor/iron,
/area/hallway/primary/central/aft)
"ER" = (
/obj/item/flashlight/lamp,
/obj/structure/table/wood,
/obj/item/clothing/glasses/sunglasses,
/obj/machinery/newscaster/directional/east,
/turf/open/floor/wood,
/area/service/lawoffice/upper)
"Fu" = (
/obj/structure/table/wood,
/obj/item/paper_bin,
/obj/item/stamp/law,
/obj/item/pen,
/turf/open/floor/iron/grimy,
/area/service/lawoffice/upper)
"FL" = (
/obj/structure/table/wood,
/obj/item/storage/secure/briefcase,
/obj/item/taperecorder,
/obj/machinery/requests_console/directional/south{
	department = "Law Office";
	name = "Law Office Requests Console"
	},
/obj/structure/disposalpipe/segment{
	dir = 4
	},
/turf/open/floor/carpet/red,
/area/service/lawoffice)
"HT" = (
/obj/machinery/power/apc/auto_name/directional/south,
/obj/structure/cable,
/turf/open/floor/wood,
/area/service/lawoffice/upper)
"HV" = (
/obj/machinery/door/poddoor/preopen{
	id = "law3";
	name = "Law Office Shared Privacy Door"
	},
/obj/effect/spawner/structure/window/reinforced,
/turf/open/floor/plating,
/area/service/lawoffice/upper)
"Iq" = (
/obj/machinery/button/door/directional/north{
	id = "Prosecution1";
	name = "Prosecution Office Privacy";
	pixel_x = 25;
	pixel_y = 0;
	req_access_txt = "38"
	},
/obj/structure/cable,
/obj/structure/disposalpipe/segment,
/turf/open/floor/carpet/red,
/area/service/lawoffice)
"Jv" = (
/obj/modular_map_connector,
/turf/open/floor/iron,
/area/hallway/primary/central/aft)
"JH" = (
/obj/structure/cable,
/obj/machinery/atmospherics/pipe/smart/manifold4w/supply/hidden/layer4,
/obj/machinery/atmospherics/pipe/smart/manifold4w/scrubbers/hidden/layer2,
/turf/open/floor/carpet/red,
/area/service/lawoffice)
"JU" = (
/obj/structure/sign/directions/medical{
	dir = 1
	},
/obj/structure/sign/directions/science{
	dir = 8;
	pixel_y = -8
	},
/obj/structure/sign/directions/supply{
	dir = 8;
	pixel_y = 8
	},
/turf/closed/wall,
/area/service/lawoffice/upper)
"Of" = (
/obj/structure/bookcase,
/turf/open/floor/wood,
/area/service/lawoffice/upper)
"OW" = (
/turf/open/floor/wood,
/area/service/lawoffice/upper)
"Qa" = (
/obj/structure/chair/comfy/black{
	dir = 1
	},
/obj/effect/landmark/start/lawyer,
/obj/machinery/newscaster/directional/south,
/obj/structure/disposalpipe/segment{
	dir = 4
	},
/turf/open/floor/carpet/red,
/area/service/lawoffice)
"QA" = (
/turf/closed/wall/r_wall,
/area/service/lawoffice/upper)
"Sr" = (
/obj/structure/filingcabinet/chestdrawer/wheeled,
/obj/item/toy/figure/lawyer{
	pixel_y = 9
	},
/turf/open/floor/wood,
/area/service/lawoffice/upper)
"SP" = (
/obj/machinery/atmospherics/pipe/smart/manifold4w/supply/hidden/layer4,
/obj/machinery/atmospherics/pipe/smart/manifold4w/scrubbers/hidden/layer2,
/obj/structure/cable,
/obj/structure/disposalpipe/segment,
/turf/open/floor/iron/grimy,
/area/service/lawoffice/upper)
"SS" = (
/obj/machinery/door/airlock/maintenance{
	name = "Public Defender Maintenance";
	req_access_txt = "38"
	},
/turf/open/floor/wood,
/area/service/lawoffice/upper)
"Ux" = (
/obj/machinery/atmospherics/components/unary/vent_scrubber/on/layer2{
	dir = 1
	},
/obj/structure/disposalpipe/segment{
	dir = 5
	},
/turf/open/floor/iron,
/area/hallway/primary/central/aft)
"UV" = (
/obj/structure/chair/wood,
/turf/open/floor/iron/grimy,
/area/service/lawoffice/upper)
"VJ" = (
/obj/machinery/atmospherics/pipe/smart/manifold4w/supply/hidden/layer4,
/obj/machinery/atmospherics/pipe/smart/manifold4w/scrubbers/hidden/layer2,
/obj/structure/cable,
/turf/open/floor/carpet/red,
/area/service/lawoffice)
"VR" = (
/obj/machinery/photocopier,
/obj/machinery/light/directional/west,
/obj/machinery/airalarm/directional/west,
/turf/open/floor/wood,
/area/service/lawoffice/upper)
"Xh" = (
/obj/machinery/door/poddoor/preopen{
	id = "Prosecution1";
	name = "Prosecution Office Privacy"
	},
/obj/effect/spawner/structure/window/reinforced,
/turf/open/floor/plating,
/area/service/lawoffice)
"Xr" = (
/obj/machinery/atmospherics/pipe/smart/manifold4w/scrubbers/hidden/layer2,
/obj/structure/chair/comfy/black,
/obj/structure/cable,
/turf/open/floor/carpet/red,
/area/service/lawoffice)
"Xz" = (
/obj/structure/chair/wood,
/obj/machinery/atmospherics/components/unary/vent_pump/on/layer4{
	dir = 1
	},
/obj/effect/landmark/start/lawyer,
/turf/open/floor/iron/grimy,
/area/service/lawoffice/upper)
"XS" = (
/obj/machinery/vending/wardrobe/law_wardrobe,
/obj/item/radio/intercom/directional/south,
/turf/open/floor/wood,
/area/service/lawoffice/upper)
"XY" = (
/obj/machinery/status_display/evac/directional/north,
/obj/machinery/camera/directional/north{
	c_tag = "Law Office";
	name = "Law Office Camera"
	},
/turf/open/floor/carpet/red,
/area/service/lawoffice)
"Yw" = (
/obj/machinery/photocopier,
/turf/open/floor/carpet/red,
/area/service/lawoffice)
"Ze" = (
/obj/structure/table/wood,
/obj/item/book/manual/wiki/security_space_law,
/obj/item/taperecorder,
/turf/open/floor/iron/grimy,
/area/service/lawoffice/upper)
"ZI" = (
/obj/structure/bookcase,
/obj/machinery/light_switch/directional/north,
/turf/open/floor/carpet/red,
/area/service/lawoffice)
"ZZ" = (
/obj/machinery/disposal/bin,
/obj/structure/disposalpipe/trunk,
/turf/open/floor/carpet/red,
/area/service/lawoffice)

(1,1,1) = {"
DM
pk
pk
pk
Xh
la
pk
"}
(2,1,1) = {"
DM
pk
ZI
VJ
JH
yb
pk
"}
(3,1,1) = {"
DM
pk
Yw
wD
tV
FL
pk
"}
(4,1,1) = {"
DM
pk
XY
Xr
vV
Qa
pk
"}
(5,1,1) = {"
DM
Xh
hm
xR
km
kg
pk
"}
(6,1,1) = {"
DM
Xh
ZZ
yC
Iq
cN
ui
"}
(7,1,1) = {"
Jv
pk
pk
pk
pk
pk
pk
"}
(8,1,1) = {"
DM
xv
Of
VR
qz
AB
xv
"}
(9,1,1) = {"
mV
oF
SP
Bx
kw
HT
xv
"}
(10,1,1) = {"
DM
HV
gB
te
te
OW
SS
"}
(11,1,1) = {"
DM
HV
gB
Xz
Fu
hq
xv
"}
(12,1,1) = {"
DM
xv
de
UV
Ze
xb
xv
"}
(13,1,1) = {"
DM
JU
Sr
iq
ER
XS
xv
"}
(14,1,1) = {"
Ux
QA
QA
QA
QA
QA
QA
"}
