//MAP CONVERTED BY dmm2tgm.py THIS HEADER COMMENT PREVENTS RECONVERSION, DO NOT REMOVE
"a" = (
/turf/closed/wall,
/area/station/medical/psychology)
"d" = (
/obj/structure/chair/comfy/brown{
	color = "#87CEFA";
	dir = 4
	},
/turf/open/floor/carpet/orange,
/area/station/medical/psychology)
"f" = (
/obj/machinery/atmospherics/pipe/smart/manifold4w/supply/hidden/layer4,
/obj/machinery/atmospherics/pipe/smart/manifold4w/scrubbers/hidden/layer2,
/obj/structure/cable,
/turf/open/floor/carpet,
/area/station/medical/psychology)
"g" = (
/obj/structure/bookcase/random/reference,
/turf/open/floor/carpet/orange,
/area/station/medical/psychology)
"l" = (
/obj/machinery/door/airlock{
	name = "Psychology Office"
	},
/obj/effect/mapping_helpers/airlock/cyclelink_helper_multi{
	cycle_id = "Psychology"
	},
/obj/machinery/atmospherics/pipe/smart/manifold4w/supply/hidden/layer4,
/obj/machinery/atmospherics/pipe/smart/manifold4w/scrubbers/hidden/layer2,
/obj/structure/cable,
/obj/modular_map_connector{
	dir = 1
	},
/obj/structure/disposalpipe/segment,
/obj/effect/mapping_helpers/airlock/access/any/medical/psychology,
/turf/open/floor/carpet/orange,
/area/station/medical/psychology)
"n" = (
/obj/machinery/light/directional/east,
/obj/machinery/light_switch/directional/east,
/obj/structure/chair/comfy/brown{
	dir = 8
	},
/obj/effect/landmark/start/psychologist,
/turf/open/floor/carpet/orange,
/area/station/medical/psychology)
"p" = (
/obj/machinery/newscaster/directional/west,
/obj/structure/bed,
/obj/item/bedsheet/cmo,
/turf/open/floor/carpet,
/area/station/medical/psychology)
"q" = (
/obj/item/kirbyplants/random,
/turf/open/floor/carpet/orange,
/area/station/medical/psychology)
"r" = (
/obj/machinery/atmospherics/pipe/smart/manifold4w/supply/hidden/layer4,
/obj/machinery/atmospherics/pipe/smart/manifold4w/scrubbers/hidden/layer2,
/obj/structure/cable,
/obj/structure/disposalpipe/segment{
	dir = 6
	},
/turf/open/floor/carpet/orange,
/area/station/medical/psychology)
"s" = (
/turf/open/floor/carpet/orange,
/area/station/medical/psychology)
"t" = (
/obj/machinery/button/door/directional/south{
	id = "psychology";
	name = "Psychology Privacy Shutters"
	},
/turf/open/floor/carpet/orange,
/area/station/medical/psychology)
"u" = (
/obj/machinery/door/airlock/maintenance{
	name = "Medbay maintenance access"
	},
/obj/effect/mapping_helpers/airlock/access/any/medical/psychology,
/turf/open/floor/plating,
/area/station/medical/psychology)
"v" = (
/obj/machinery/door/airlock{
	name = "Psychology Office"
	},
/obj/effect/mapping_helpers/airlock/cyclelink_helper_multi{
	cycle_id = "Psychology"
	},
/obj/effect/mapping_helpers/airlock/access/any/medical/psychology,
/turf/open/floor/carpet,
/area/station/medical/psychology)
"w" = (
/obj/machinery/airalarm/directional/east,
/obj/structure/table/wood,
/obj/machinery/requests_console/directional/north{
	department = "Psychology";
	name = "Psychologist Requests Console"
	},
/obj/machinery/computer/med_data/laptop,
/turf/open/floor/carpet/orange,
/area/station/medical/psychology)
"x" = (
/obj/machinery/atmospherics/components/unary/vent_scrubber/on/layer2{
	dir = 8
	},
/obj/machinery/power/apc/auto_name/directional/north,
/obj/structure/cable,
/turf/open/floor/carpet/orange,
/area/station/medical/psychology)
"A" = (
/obj/structure/fireplace,
/turf/open/floor/carpet/orange,
/area/station/medical/psychology)
"B" = (
/obj/structure/disposalpipe/segment{
	dir = 4
	},
/turf/open/floor/carpet/orange,
/area/station/medical/psychology)
"D" = (
/obj/machinery/holopad,
/obj/machinery/atmospherics/pipe/smart/manifold4w/supply/hidden/layer4,
/obj/machinery/atmospherics/pipe/smart/manifold4w/scrubbers/hidden/layer2,
/obj/structure/cable,
/turf/open/floor/carpet,
/area/station/medical/psychology)
"E" = (
/turf/open/floor/carpet,
/area/station/medical/psychology)
"F" = (
/obj/structure/table/wood,
/obj/item/paper_bin/construction,
/obj/item/storage/crayons,
/obj/item/pen,
/turf/open/floor/carpet/orange,
/area/station/medical/psychology)
"G" = (
/obj/structure/chair/sofa/left{
	desc = "Made of very expensive furs, probably from an endangered animal.";
	dir = 4;
	name = "Luxurious sofa"
	},
/obj/machinery/light/directional/west,
/obj/item/radio/intercom/directional/west,
/turf/open/floor/carpet/orange,
/area/station/medical/psychology)
"H" = (
/mob/living/simple_animal/pet/dog/bullterrier{
	name = "Burton";
	real_name = "Burton"
	},
/turf/open/floor/carpet/orange,
/area/station/medical/psychology)
"J" = (
/obj/machinery/disposal/bin,
/obj/structure/disposalpipe/trunk{
	dir = 8
	},
/turf/open/floor/carpet/orange,
/area/station/medical/psychology)
"K" = (
/obj/effect/landmark/start/psychologist,
/turf/open/floor/carpet,
/area/station/medical/psychology)
"L" = (
/obj/structure/table/wood,
/obj/item/folder/blue,
/obj/item/pen,
/turf/open/floor/carpet/orange,
/area/station/medical/psychology)
"M" = (
/obj/effect/spawner/structure/window/reinforced,
/obj/machinery/door/poddoor/preopen{
	id = "psychology";
	name = "Psychology Privacy Door"
	},
/turf/open/floor/plating,
/area/station/medical/psychology)
"N" = (
/obj/machinery/door/airlock{
	name = "Psychology Office"
	},
/obj/effect/mapping_helpers/airlock/cyclelink_helper_multi{
	cycle_id = "Psychology"
	},
/obj/effect/mapping_helpers/airlock/access/any/medical/psychology,
/turf/open/floor/carpet/orange,
/area/station/medical/psychology)
"P" = (
/obj/machinery/atmospherics/components/unary/vent_pump/on/layer4{
	dir = 4
	},
/turf/open/floor/carpet/orange,
/area/station/medical/psychology)
"Q" = (
/obj/structure/chair/sofa/right{
	desc = "Made of very expensive furs, probably from an endangered animal.";
	dir = 4;
	name = "Luxurious sofa"
	},
/obj/machinery/newscaster/directional/west,
/turf/open/floor/carpet/orange,
/area/station/medical/psychology)
"S" = (
/obj/machinery/light/directional/east,
/obj/structure/chair/comfy/brown{
	dir = 8
	},
/turf/open/floor/carpet/orange,
/area/station/medical/psychology)
"T" = (
/obj/structure/table/wood,
/obj/item/flashlight/lamp/green,
/turf/open/floor/carpet,
/area/station/medical/psychology)
"U" = (
/obj/machinery/camera/directional/west{
	c_tag = "Psychology Office";
	name = "Psychology Camera";
	network = list("ss13","medbay")
	},
/obj/item/toy/plush/moth,
/obj/structure/table/wood,
/turf/open/floor/carpet/orange,
/area/station/medical/psychology)
"W" = (
/obj/machinery/atmospherics/pipe/smart/manifold4w/supply/hidden/layer4,
/obj/machinery/atmospherics/pipe/smart/manifold4w/scrubbers/hidden/layer2,
/obj/structure/cable,
/turf/open/floor/carpet/orange,
/area/station/medical/psychology)
"Z" = (
/obj/structure/closet/secure_closet/psychology,
/obj/item/food/grown/tobacco,
/obj/item/food/grown/tobacco,
/obj/item/food/grown/tobacco,
/obj/item/clothing/mask/cigarette/pipe,
/turf/open/floor/carpet,
/area/station/medical/psychology)

(1,1,1) = {"
a
a
u
a
a
a
a
a
a
"}
(2,1,1) = {"
a
g
d
L
U
G
Q
F
a
"}
(3,1,1) = {"
a
A
s
H
P
E
E
t
a
"}
(4,1,1) = {"
a
g
S
q
W
f
D
r
l
"}
(5,1,1) = {"
a
a
a
a
x
E
E
B
M
"}
(6,1,1) = {"
a
p
K
v
s
E
E
B
M
"}
(7,1,1) = {"
a
Z
T
a
w
n
s
J
a
"}
(8,1,1) = {"
a
a
a
a
a
a
N
a
a
"}
