//MAP CONVERTED BY dmm2tgm.py THIS HEADER COMMENT PREVENTS RECONVERSION, DO NOT REMOVE
"a" = (
/turf/closed/wall,
/area/station/medical/psychology)
"b" = (
/obj/machinery/atmospherics/pipe/smart/manifold4w/supply/hidden/layer4,
/obj/machinery/atmospherics/pipe/smart/manifold4w/scrubbers/hidden/layer2,
/obj/structure/cable,
/obj/structure/disposalpipe/segment{
	dir = 6
	},
/turf/open/floor/carpet/orange,
/area/station/medical/psychology)
"d" = (
/obj/structure/table/wood,
/obj/item/paper_bin,
/obj/item/pen,
/obj/item/food/grown/tobacco,
/obj/item/food/grown/tobacco,
/obj/item/food/grown/tobacco,
/turf/open/floor/carpet,
/area/station/medical/psychology)
"e" = (
/turf/closed/wall,
/area/station/maintenance/department/medical/central)
"g" = (
/obj/structure/table/wood,
/obj/item/folder/blue,
/obj/item/pen,
/obj/item/clothing/mask/cigarette/pipe,
/turf/open/floor/carpet,
/area/station/medical/psychology)
"i" = (
/obj/structure/table/wood,
/obj/machinery/computer/med_data/laptop{
	pixel_y = 1
	},
/obj/machinery/status_display/evac/directional/north,
/turf/open/floor/carpet,
/area/station/medical/psychology)
"j" = (
/obj/structure/chair/comfy/brown,
/turf/open/floor/carpet,
/area/station/medical/psychology)
"l" = (
/obj/structure/chair/comfy/black{
	dir = 1
	},
/obj/effect/landmark/start/psychologist,
/turf/open/floor/carpet,
/area/station/medical/psychology)
"q" = (
/obj/structure/chair/stool/bar/directional/south,
/turf/open/floor/plating,
/area/station/maintenance/department/medical/central)
"r" = (
/obj/machinery/camera/directional/west{
	c_tag = "Psychology Office";
	name = "Psychology Camera";
	network = list("ss13","medbay")
	},
/obj/item/toy/plush/moth,
/obj/structure/table/wood,
/turf/open/floor/carpet/orange,
/area/station/medical/psychology)
"s" = (
/obj/machinery/door/airlock{
	name = "Psychology Office"
	},
/obj/effect/mapping_helpers/airlock/cyclelink_helper_multi{
	cycle_id = "Psychology"
	},
/obj/machinery/atmospherics/pipe/smart/manifold4w/supply/hidden/layer4,
/obj/machinery/atmospherics/pipe/smart/manifold4w/scrubbers/hidden/layer2,
/obj/structure/cable,
/obj/modular_map_connector{
	dir = 1
	},
/obj/structure/disposalpipe/segment,
/obj/effect/mapping_helpers/airlock/access/any/medical/psychology,
/turf/open/floor/carpet/orange,
/area/station/medical/psychology)
"t" = (
/mob/living/simple_animal/pet/dog/bullterrier{
	name = "Burton";
	real_name = "Burton"
	},
/turf/open/floor/carpet/orange,
/area/station/medical/psychology)
"u" = (
/obj/structure/chair/sofa/right{
	desc = "Made of very expensive furs, probably from an endangered animal.";
	dir = 4;
	name = "Luxurious sofa"
	},
/obj/machinery/newscaster/directional/west,
/turf/open/floor/carpet/orange,
/area/station/medical/psychology)
"y" = (
/obj/structure/bonfire,
/turf/open/floor/plating,
/area/station/maintenance/department/medical/central)
"z" = (
/obj/structure/cable,
/obj/machinery/disposal/bin,
/obj/structure/disposalpipe/trunk{
	dir = 8
	},
/turf/open/floor/carpet/orange,
/area/station/medical/psychology)
"A" = (
/obj/effect/spawner/structure/window/reinforced,
/obj/machinery/door/poddoor/preopen{
	id = "psychology";
	name = "Psychology Privacy Door"
	},
/turf/open/floor/plating,
/area/station/medical/psychology)
"B" = (
/obj/structure/filingcabinet,
/obj/item/folder/white,
/obj/item/folder/white,
/obj/machinery/airalarm/directional/west,
/turf/open/floor/carpet,
/area/station/medical/psychology)
"C" = (
/obj/structure/table/wood,
/turf/open/floor/carpet,
/area/station/medical/psychology)
"D" = (
/obj/machinery/light/directional/east,
/obj/machinery/button/door/directional/east{
	id = "psychology";
	name = "Psychology Privacy Shutters"
	},
/turf/open/floor/carpet/orange,
/area/station/medical/psychology)
"E" = (
/obj/machinery/atmospherics/components/unary/vent_pump/on/layer4,
/turf/open/floor/carpet,
/area/station/medical/psychology)
"H" = (
/obj/structure/table,
/obj/item/melee/roastingstick,
/turf/open/floor/plating,
/area/station/maintenance/department/medical/central)
"I" = (
/obj/machinery/holopad,
/obj/machinery/atmospherics/pipe/smart/manifold4w/supply/hidden/layer4,
/obj/machinery/atmospherics/pipe/smart/manifold4w/scrubbers/hidden/layer2,
/turf/open/floor/carpet/orange,
/area/station/medical/psychology)
"L" = (
/obj/structure/table/wood,
/obj/item/flashlight/lamp/green,
/turf/open/floor/carpet,
/area/station/medical/psychology)
"N" = (
/obj/machinery/atmospherics/components/unary/vent_scrubber/on/layer2{
	dir = 8
	},
/turf/open/floor/carpet/orange,
/area/station/medical/psychology)
"O" = (
/obj/structure/cable,
/obj/structure/disposalpipe/segment{
	dir = 4
	},
/turf/open/floor/carpet/orange,
/area/station/medical/psychology)
"P" = (
/obj/structure/fireplace,
/turf/open/floor/carpet,
/area/station/medical/psychology)
"Q" = (
/obj/machinery/power/apc/auto_name/directional/east,
/obj/structure/cable,
/obj/machinery/vending/drugs,
/turf/open/floor/carpet/orange,
/area/station/medical/psychology)
"R" = (
/turf/open/floor/carpet,
/area/station/medical/psychology)
"S" = (
/obj/machinery/door/airlock{
	name = "Psychology Office"
	},
/obj/effect/mapping_helpers/airlock/cyclelink_helper_multi{
	cycle_id = "Psychology"
	},
/obj/effect/mapping_helpers/airlock/access/any/medical/psychology,
/turf/open/floor/carpet/orange,
/area/station/medical/psychology)
"U" = (
/obj/structure/chair/sofa/left{
	desc = "Made of very expensive furs, probably from an endangered animal.";
	dir = 4;
	name = "Luxurious sofa"
	},
/obj/machinery/light/directional/west,
/obj/item/radio/intercom/directional/west,
/turf/open/floor/carpet/orange,
/area/station/medical/psychology)
"V" = (
/turf/open/floor/carpet/orange,
/area/station/medical/psychology)
"W" = (
/obj/structure/chair/comfy/brown,
/obj/machinery/requests_console/directional/north{
	department = "Psychology";
	name = "Psychologist Requests Console"
	},
/obj/effect/landmark/start/psychologist,
/turf/open/floor/carpet,
/area/station/medical/psychology)
"X" = (
/obj/structure/table/wood,
/obj/item/paper_bin/construction,
/turf/open/floor/carpet/orange,
/area/station/medical/psychology)
"Y" = (
/obj/machinery/atmospherics/pipe/smart/manifold4w/supply/hidden/layer4,
/obj/machinery/atmospherics/pipe/smart/manifold4w/scrubbers/hidden/layer2,
/turf/open/floor/carpet/orange,
/area/station/medical/psychology)
"Z" = (
/obj/structure/table/wood,
/obj/item/storage/crayons,
/obj/item/pen,
/obj/machinery/light_switch/directional/south,
/turf/open/floor/carpet/orange,
/area/station/medical/psychology)

(1,1,1) = {"
a
a
a
a
a
a
a
a
a
"}
(2,1,1) = {"
a
L
C
B
r
U
u
X
a
"}
(3,1,1) = {"
a
i
l
R
t
V
V
Z
a
"}
(4,1,1) = {"
a
d
g
E
Y
Y
I
b
s
"}
(5,1,1) = {"
e
e
e
j
N
V
V
O
a
"}
(6,1,1) = {"
q
y
e
P
V
V
V
z
a
"}
(7,1,1) = {"
q
H
e
W
V
D
V
Q
a
"}
(8,1,1) = {"
e
e
e
A
A
a
S
a
a
"}
