//MAP CONVERTED BY dmm2tgm.py THIS HEADER COMMENT PREVENTS RECONVERSION, DO NOT REMOVE
"a" = (
/turf/closed/wall,
/area/maintenance/department/medical/central)
"b" = (
/obj/structure/chair{
	dir = 1
	},
/obj/machinery/firealarm/directional/south,
/obj/machinery/atmospherics/components/unary/vent_scrubber/on/layer2{
	dir = 4
	},
/turf/open/floor/iron/dark,
/area/medical/surgery)
"d" = (
/obj/structure/table,
/obj/machinery/newscaster/directional/west,
/obj/item/reagent_containers/food/drinks/coffee,
/turf/open/floor/iron/dark,
/area/medical/surgery)
"e" = (
/obj/structure/chair{
	dir = 1
	},
/obj/machinery/atmospherics/pipe/smart/manifold4w/supply/hidden/layer4,
/obj/machinery/atmospherics/pipe/smart/manifold4w/scrubbers/hidden/layer2,
/obj/effect/landmark/start/paramedic,
/turf/open/floor/iron/dark,
/area/medical/surgery)
"f" = (
/obj/structure/closet/secure_closet/medical2,
/obj/machinery/newscaster/directional/east,
/turf/open/floor/iron/white,
/area/medical/surgery)
"g" = (
/obj/machinery/vending/wallmed/directional/west,
/obj/structure/table,
/obj/item/storage/backpack/duffelbag/med/surgery,
/obj/item/reagent_containers/medigel/sterilizine,
/obj/structure/cable,
/turf/open/floor/iron/white,
/area/medical/surgery)
"h" = (
/obj/machinery/computer/operating,
/obj/item/radio/intercom/directional/north,
/obj/machinery/light/directional/east,
/obj/machinery/requests_console/directional/east{
	department = "Medbay";
	name = "Surgery B Requests Console"
	},
/turf/open/floor/iron/white,
/area/medical/surgery)
"k" = (
/obj/machinery/atmospherics/components/unary/vent_scrubber/on/layer2,
/obj/structure/cable,
/obj/machinery/atmospherics/pipe/smart/manifold4w/supply/hidden/layer4,
/obj/effect/landmark/start/medical_doctor,
/turf/open/floor/iron/white,
/area/medical/surgery)
"m" = (
/obj/machinery/smartfridge/organ,
/obj/machinery/door/poddoor/preopen{
	id = "surgeryblock";
	name = "Surgery Privacy Door"
	},
/turf/closed/wall,
/area/medical/surgery)
"n" = (
/obj/structure/cable,
/obj/machinery/atmospherics/pipe/smart/manifold4w/supply/hidden/layer4,
/obj/machinery/atmospherics/pipe/smart/manifold4w/scrubbers/hidden/layer2,
/obj/effect/landmark/start/paramedic,
/turf/open/floor/iron/dark,
/area/medical/surgery)
"o" = (
/obj/structure/chair{
	dir = 1
	},
/turf/open/floor/iron/dark,
/area/medical/surgery)
"p" = (
/obj/machinery/door/airlock/medical{
	name = "Operating Theatre A";
	req_access_txt = "45"
	},
/obj/structure/cable,
/obj/machinery/atmospherics/pipe/smart/manifold4w/supply/hidden/layer4,
/obj/machinery/atmospherics/pipe/smart/manifold4w/scrubbers/hidden/layer2,
/turf/open/floor/iron/white,
/area/medical/surgery)
"r" = (
/obj/machinery/vending/wallmed/directional/east,
/obj/structure/table,
/obj/item/storage/backpack/duffelbag/med/surgery,
/obj/item/reagent_containers/medigel/sterilizine,
/turf/open/floor/iron/white,
/area/medical/surgery)
"s" = (
/obj/machinery/door/airlock/medical{
	name = "Operating Theatre B";
	req_access_txt = "45"
	},
/obj/machinery/atmospherics/pipe/smart/manifold4w/supply/hidden/layer4,
/obj/machinery/atmospherics/pipe/smart/manifold4w/scrubbers/hidden/layer2,
/turf/open/floor/iron/white,
/area/medical/surgery)
"t" = (
/obj/machinery/door/airlock/medical/glass{
	name = "Surgery Observation"
	},
/obj/structure/cable,
/obj/machinery/atmospherics/pipe/smart/manifold4w/supply/hidden/layer4,
/obj/machinery/atmospherics/pipe/smart/manifold4w/scrubbers/hidden/layer2,
/obj/modular_map_connector{
	dir = 1
	},
/turf/open/floor/iron/dark,
/area/medical/surgery)
"u" = (
/obj/structure/closet/secure_closet/medical2,
/obj/machinery/newscaster/directional/west,
/turf/open/floor/iron/white,
/area/medical/surgery)
"v" = (
/obj/structure/table,
/obj/item/clothing/suit/apron/surgical,
/obj/item/clothing/gloves/color/latex,
/obj/machinery/airalarm/directional/north,
/turf/open/floor/iron/white,
/area/medical/surgery)
"x" = (
/obj/structure/table,
/obj/item/radio/intercom/directional/north,
/obj/item/clothing/suit/apron/surgical,
/obj/item/clothing/mask/surgical,
/turf/open/floor/iron/white,
/area/medical/surgery)
"y" = (
/obj/effect/spawner/structure/window/reinforced,
/obj/machinery/door/poddoor/preopen{
	id = "surgeryblock";
	name = "Surgery Privacy Door"
	},
/turf/open/floor/plating,
/area/medical/surgery)
"z" = (
/obj/machinery/atmospherics/components/unary/vent_pump/on/layer4{
	dir = 8
	},
/turf/open/floor/iron/white,
/area/medical/surgery)
"A" = (
/turf/closed/wall,
/area/medical/surgery)
"B" = (
/obj/structure/cable,
/obj/machinery/atmospherics/pipe/smart/manifold4w/supply/hidden/layer4,
/obj/machinery/atmospherics/pipe/smart/manifold4w/scrubbers/hidden/layer2,
/turf/open/floor/iron/white,
/area/medical/surgery)
"C" = (
/obj/machinery/holopad,
/turf/open/floor/iron/dark,
/area/medical/surgery)
"D" = (
/obj/structure/table/optable,
/obj/machinery/button/door/directional/north{
	id = "surgeryblock";
	name = "Privacy Button";
	pixel_x = 6;
	req_access_txt = "5"
	},
/obj/machinery/button/door/directional/north{
	id = "surgeryBblock";
	name = "Outter Privacy Button";
	pixel_x = -6;
	req_access_txt = "5"
	},
/turf/open/floor/iron/white,
/area/medical/surgery)
"E" = (
/obj/machinery/atmospherics/components/unary/vent_scrubber/on/layer2,
/obj/machinery/atmospherics/pipe/smart/manifold4w/supply/hidden/layer4,
/obj/effect/landmark/start/medical_doctor,
/turf/open/floor/iron/white,
/area/medical/surgery)
"F" = (
/obj/machinery/atmospherics/components/unary/vent_pump/on/layer4{
	dir = 4
	},
/turf/open/floor/iron/white,
/area/medical/surgery)
"G" = (
/obj/structure/closet/crate/freezer/blood,
/turf/open/floor/iron/white,
/area/medical/surgery)
"I" = (
/obj/structure/closet/crate/freezer/surplus_limbs,
/turf/open/floor/iron/white,
/area/medical/surgery)
"J" = (
/obj/structure/cable,
/obj/machinery/atmospherics/pipe/smart/manifold4w/supply/hidden/layer4,
/obj/machinery/atmospherics/pipe/smart/manifold4w/scrubbers/hidden/layer2,
/turf/open/floor/iron/dark,
/area/medical/surgery)
"K" = (
/obj/machinery/atmospherics/pipe/smart/manifold4w/supply/hidden/layer4,
/obj/machinery/atmospherics/pipe/smart/manifold4w/scrubbers/hidden/layer2,
/turf/open/floor/iron/white,
/area/medical/surgery)
"L" = (
/obj/structure/extinguisher_cabinet/directional/east,
/obj/machinery/iv_drip,
/turf/open/floor/iron/dark,
/area/medical/surgery)
"M" = (
/obj/effect/spawner/structure/window/reinforced,
/obj/machinery/door/poddoor/preopen{
	id = "surgeryAblock";
	name = "Surgery A Privacy Door"
	},
/turf/open/floor/plating,
/area/medical/surgery)
"O" = (
/obj/effect/spawner/structure/window/reinforced,
/obj/machinery/door/poddoor/preopen{
	id = "surgeryBblock";
	name = "Surgery B Privacy Door"
	},
/turf/open/floor/plating,
/area/medical/surgery)
"Q" = (
/obj/machinery/vending/drugs,
/turf/open/floor/iron/white/textured_large,
/area/medical/surgery)
"R" = (
/obj/machinery/computer/operating,
/obj/machinery/power/apc/auto_name/directional/north,
/obj/structure/cable,
/obj/machinery/light/directional/west,
/obj/machinery/requests_console/directional/west{
	department = "Medbay";
	name = "Surgery A Requests Console"
	},
/turf/open/floor/iron/white,
/area/medical/surgery)
"S" = (
/obj/structure/chair{
	dir = 1
	},
/obj/machinery/atmospherics/components/unary/vent_pump/on/layer4,
/turf/open/floor/iron/dark,
/area/medical/surgery)
"T" = (
/obj/structure/table/optable,
/obj/machinery/button/door/directional/north{
	id = "surgeryblock";
	name = "Privacy Button";
	pixel_x = 6;
	req_access_txt = "5"
	},
/obj/machinery/button/door/directional/north{
	id = "surgeryAblock";
	name = "Outter Privacy Button";
	pixel_x = -6;
	req_access_txt = "5"
	},
/turf/open/floor/iron/white,
/area/medical/surgery)
"U" = (
/obj/machinery/atmospherics/pipe/smart/manifold4w/supply/hidden/layer4,
/obj/machinery/atmospherics/pipe/smart/manifold4w/scrubbers/hidden/layer2,
/turf/open/floor/iron/dark,
/area/medical/surgery)
"V" = (
/obj/machinery/iv_drip,
/turf/open/floor/iron/dark,
/area/medical/surgery)
"W" = (
/obj/machinery/light/directional/south,
/turf/open/floor/iron/dark,
/area/medical/surgery)

(1,1,1) = {"
a
A
A
A
A
A
A
A
A
"}
(2,1,1) = {"
a
R
g
u
M
o
d
o
A
"}
(3,1,1) = {"
a
T
k
B
p
J
J
W
A
"}
(4,1,1) = {"
a
x
z
I
M
S
n
b
A
"}
(5,1,1) = {"
a
m
y
y
y
C
J
J
t
"}
(6,1,1) = {"
a
v
F
G
O
e
U
o
A
"}
(7,1,1) = {"
a
D
E
K
s
U
W
A
A
"}
(8,1,1) = {"
a
h
r
f
O
L
V
A
Q
"}
(9,1,1) = {"
a
A
A
A
A
A
A
A
A
"}
