//MAP CONVERTED BY dmm2tgm.py THIS HEADER COMMENT PREVENTS RECONVERSION, DO NOT REMOVE
"a" = (
/turf/closed/wall,
/area/station/maintenance/department/medical/central)
"b" = (
/obj/structure/chair{
	dir = 1
	},
/obj/machinery/firealarm/directional/south,
/turf/open/floor/iron/dark,
/area/station/medical/surgery)
"d" = (
/obj/structure/table,
/obj/machinery/newscaster/directional/west,
/turf/open/floor/iron/dark,
/area/station/medical/surgery)
"e" = (
/obj/structure/chair{
	dir = 1
	},
/obj/machinery/atmospherics/components/unary/vent_scrubber/on/layer2,
/turf/open/floor/iron/dark,
/area/station/medical/surgery)
"f" = (
/obj/structure/closet/secure_closet/medical2,
/obj/machinery/newscaster/directional/east,
/turf/open/floor/iron/white,
/area/station/medical/surgery)
"g" = (
/obj/machinery/vending/wallmed/directional/west,
/obj/structure/table,
/obj/item/storage/backpack/duffelbag/med/surgery,
/obj/item/reagent_containers/medigel/sterilizine,
/obj/structure/cable,
/turf/open/floor/iron/white,
/area/station/medical/surgery)
"h" = (
/obj/machinery/computer/operating,
/obj/item/radio/intercom/directional/north,
/obj/machinery/light/directional/east,
/obj/machinery/requests_console/directional/east{
	department = "Medbay";
	name = "Surgery B Requests Console"
	},
/turf/open/floor/iron/white,
/area/station/medical/surgery)
"j" = (
/turf/closed/wall,
/area/station/medical/surgery)
"k" = (
/obj/machinery/atmospherics/components/unary/vent_scrubber/on/layer2,
/obj/structure/cable,
/obj/machinery/atmospherics/pipe/smart/manifold4w/supply/hidden/layer4,
/obj/effect/landmark/start/medical_doctor,
/turf/open/floor/iron/white,
/area/station/medical/surgery)
"l" = (
/obj/machinery/vending/drugs,
/turf/open/floor/iron/dark,
/area/station/medical/surgery)
"m" = (
/obj/machinery/smartfridge/organ,
/obj/machinery/door/poddoor/preopen{
	id = "surgeryblock";
	name = "Surgery Privacy Door"
	},
/turf/closed/wall,
/area/station/medical/surgery)
"o" = (
/obj/structure/chair{
	dir = 1
	},
/turf/open/floor/iron/dark,
/area/station/medical/surgery)
"p" = (
/obj/machinery/door/airlock/medical{
	name = "Operating Theatre A";
	req_access_txt = "45"
	},
/obj/structure/cable,
/obj/machinery/atmospherics/pipe/smart/manifold4w/supply/hidden/layer4,
/obj/machinery/atmospherics/pipe/smart/manifold4w/scrubbers/hidden/layer2,
/turf/open/floor/iron/white,
/area/station/medical/surgery)
"r" = (
/obj/machinery/vending/wallmed/directional/east,
/obj/structure/table,
/obj/item/storage/backpack/duffelbag/med/surgery,
/obj/item/reagent_containers/medigel/sterilizine,
/turf/open/floor/iron/white,
/area/station/medical/surgery)
"s" = (
/obj/machinery/door/airlock/medical{
	name = "Operating Theatre B";
	req_access_txt = "45"
	},
/obj/machinery/atmospherics/pipe/smart/manifold4w/supply/hidden/layer4,
/obj/machinery/atmospherics/pipe/smart/manifold4w/scrubbers/hidden/layer2,
/turf/open/floor/iron/white,
/area/station/medical/surgery)
"t" = (
/obj/machinery/door/airlock/medical/glass{
	name = "Surgery Observation"
	},
/obj/structure/cable,
/obj/machinery/atmospherics/pipe/smart/manifold4w/supply/hidden/layer4,
/obj/machinery/atmospherics/pipe/smart/manifold4w/scrubbers/hidden/layer2,
/obj/modular_map_connector{
	dir = 1
	},
/turf/open/floor/iron/dark,
/area/station/medical/surgery)
"u" = (
/obj/structure/closet/secure_closet/medical2,
/obj/machinery/newscaster/directional/west,
/turf/open/floor/iron/white,
/area/station/medical/surgery)
"v" = (
/obj/structure/table,
/obj/item/clothing/suit/apron/surgical,
/obj/item/clothing/gloves/color/latex,
/obj/machinery/airalarm/directional/north,
/obj/item/clothing/mask/surgical,
/turf/open/floor/iron/white,
/area/station/medical/surgery)
"x" = (
/obj/item/radio/intercom/directional/north,
/obj/structure/closet/crate/freezer/surplus_limbs,
/turf/open/floor/iron/white,
/area/station/medical/surgery)
"y" = (
/obj/effect/spawner/structure/window/reinforced,
/obj/machinery/door/poddoor/preopen{
	id = "surgeryblock";
	name = "Surgery Privacy Door"
	},
/turf/open/floor/plating,
/area/station/medical/surgery)
"z" = (
/obj/machinery/atmospherics/components/unary/vent_pump/on/layer4{
	dir = 8
	},
/turf/open/floor/iron/white,
/area/station/medical/surgery)
"B" = (
/obj/structure/cable,
/obj/machinery/atmospherics/pipe/smart/manifold4w/supply/hidden/layer4,
/obj/machinery/atmospherics/pipe/smart/manifold4w/scrubbers/hidden/layer2,
/turf/open/floor/iron/white,
/area/station/medical/surgery)
"C" = (
/obj/machinery/atmospherics/pipe/smart/manifold4w/supply/hidden/layer4,
/obj/machinery/atmospherics/pipe/smart/manifold4w/scrubbers/hidden/layer2,
/obj/effect/landmark/start/paramedic,
/turf/open/floor/iron/dark,
/area/station/medical/surgery)
"D" = (
/obj/structure/table/optable,
/obj/machinery/button/door/directional/north{
	id = "surgeryblock";
	name = "Privacy Button";
	pixel_x = 6;
	req_access_txt = "5"
	},
/obj/machinery/button/door/directional/north{
	id = "surgeryBblock";
	name = "Outter Privacy Button";
	pixel_x = -6;
	req_access_txt = "5"
	},
/turf/open/floor/iron/white,
/area/station/medical/surgery)
"E" = (
/obj/machinery/atmospherics/components/unary/vent_scrubber/on/layer2,
/obj/machinery/atmospherics/pipe/smart/manifold4w/supply/hidden/layer4,
/obj/effect/landmark/start/medical_doctor,
/turf/open/floor/iron/white,
/area/station/medical/surgery)
"F" = (
/obj/machinery/atmospherics/components/unary/vent_pump/on/layer4{
	dir = 4
	},
/turf/open/floor/iron/white,
/area/station/medical/surgery)
"H" = (
/obj/structure/cable,
/obj/machinery/atmospherics/pipe/smart/manifold4w/supply/hidden/layer4,
/obj/machinery/atmospherics/pipe/smart/manifold4w/scrubbers/hidden/layer2,
/obj/effect/landmark/start/paramedic,
/turf/open/floor/iron/dark,
/area/station/medical/surgery)
"I" = (
/obj/machinery/iv_drip,
/turf/open/floor/iron/white,
/area/station/medical/surgery)
"J" = (
/obj/structure/cable,
/obj/machinery/atmospherics/pipe/smart/manifold4w/supply/hidden/layer4,
/obj/machinery/atmospherics/pipe/smart/manifold4w/scrubbers/hidden/layer2,
/turf/open/floor/iron/dark,
/area/station/medical/surgery)
"K" = (
/obj/machinery/atmospherics/pipe/smart/manifold4w/supply/hidden/layer4,
/obj/machinery/atmospherics/pipe/smart/manifold4w/scrubbers/hidden/layer2,
/turf/open/floor/iron/white,
/area/station/medical/surgery)
"L" = (
/obj/structure/chair{
	dir = 1
	},
/obj/structure/extinguisher_cabinet/directional/east,
/turf/open/floor/iron/dark,
/area/station/medical/surgery)
"M" = (
/obj/effect/spawner/structure/window/reinforced,
/obj/machinery/door/poddoor/preopen{
	id = "surgeryAblock";
	name = "Surgery A Privacy Door"
	},
/turf/open/floor/plating,
/area/station/medical/surgery)
"O" = (
/obj/effect/spawner/structure/window/reinforced,
/obj/machinery/door/poddoor/preopen{
	id = "surgeryBblock";
	name = "Surgery B Privacy Door"
	},
/turf/open/floor/plating,
/area/station/medical/surgery)
"R" = (
/obj/machinery/computer/operating,
/obj/machinery/power/apc/auto_name/directional/north,
/obj/structure/cable,
/obj/machinery/light/directional/west,
/obj/machinery/requests_console/directional/west{
	department = "Medbay";
	name = "Surgery A Requests Console"
	},
/turf/open/floor/iron/white,
/area/station/medical/surgery)
"S" = (
/obj/structure/chair{
	dir = 1
	},
/obj/machinery/atmospherics/components/unary/vent_pump/on/layer4,
/turf/open/floor/iron/dark,
/area/station/medical/surgery)
"T" = (
/obj/structure/table/optable,
/obj/machinery/button/door/directional/north{
	id = "surgeryblock";
	name = "Privacy Button";
	pixel_x = 6;
	req_access_txt = "5"
	},
/obj/machinery/button/door/directional/north{
	id = "surgeryAblock";
	name = "Outter Privacy Button";
	pixel_x = -6;
	req_access_txt = "5"
	},
/turf/open/floor/iron/white,
/area/station/medical/surgery)
"U" = (
/obj/machinery/atmospherics/pipe/smart/manifold4w/supply/hidden/layer4,
/obj/machinery/atmospherics/pipe/smart/manifold4w/scrubbers/hidden/layer2,
/turf/open/floor/iron/dark,
/area/station/medical/surgery)
"V" = (
/obj/structure/table,
/obj/item/reagent_containers/food/drinks/coffee,
/obj/machinery/newscaster/directional/east,
/turf/open/floor/iron/dark,
/area/station/medical/surgery)
"W" = (
/obj/machinery/light/directional/south,
/turf/open/floor/iron/dark,
/area/station/medical/surgery)

(1,1,1) = {"
a
j
j
j
j
j
j
j
j
"}
(2,1,1) = {"
a
R
g
u
M
o
d
o
j
"}
(3,1,1) = {"
a
T
k
B
p
J
H
W
j
"}
(4,1,1) = {"
a
x
z
I
M
S
J
b
j
"}
(5,1,1) = {"
a
m
y
y
y
l
J
J
t
"}
(6,1,1) = {"
a
v
F
I
O
e
U
o
j
"}
(7,1,1) = {"
a
D
E
K
s
U
C
W
j
"}
(8,1,1) = {"
a
h
r
f
O
L
V
o
j
"}
(9,1,1) = {"
a
j
j
j
j
j
j
j
j
"}
