//MAP CONVERTED BY dmm2tgm.py THIS HEADER COMMENT PREVENTS RECONVERSION, DO NOT REMOVE
"a" = (
/turf/open/space/basic,
/area/template_noop)
"d" = (
/obj/effect/turf_decal/siding/wood,
/turf/open/floor/holofloor/wood,
/area/ruin/space/has_grav/cateor_shrine)
"f" = (
/obj/item/flashlight/lantern/lit_lantern,
/turf/open/floor/holofloor/wood,
/area/ruin/space/has_grav/cateor_shrine)
"h" = (
/obj/item/food/deadmouse,
/turf/open/misc/asteroid,
/area/ruin/space/has_grav/cateor_shrine)
"i" = (
/obj/item/pen,
/turf/open/misc/asteroid,
/area/ruin/space/has_grav/cateor_shrine)
"j" = (
/obj/effect/decal/cleanable/cobweb/cobweb2,
/obj/structure/flora/rock,
/turf/open/misc/asteroid,
/area/ruin/space/has_grav/cateor_shrine)
"m" = (
/obj/effect/decal/remains/human,
/obj/item/paper/crumpled/ruins/cateor_shrine,
/obj/effect/decal/cleanable/dirt/dust,
/turf/open/misc/asteroid,
/area/ruin/space/has_grav/cateor_shrine)
"o" = (
/obj/structure/water_source/puddle,
/turf/open/misc/asteroid,
/area/ruin/space/has_grav/cateor_shrine)
"p" = (
/mob/living/basic/pet/cat/feral,
/obj/effect/turf_decal/siding/wood,
/turf/open/floor/holofloor/wood,
/area/ruin/space/has_grav/cateor_shrine)
"u" = (
/obj/item/toy/cattoy,
/turf/open/misc/asteroid,
/area/ruin/space/has_grav/cateor_shrine)
"y" = (
/turf/closed/mineral/random/low_chance,
/area/ruin/space/has_grav/cateor_shrine)
"C" = (
/obj/structure/mineral_door/silver,
/obj/structure/barricade/wooden/crude,
/obj/structure/barricade/wooden,
/turf/open/misc/asteroid,
/area/ruin/space/has_grav/cateor_shrine)
"E" = (
/obj/item/flashlight/lantern/lit_lantern,
/obj/effect/decal/cleanable/dirt/dust,
/turf/open/misc/asteroid,
/area/ruin/space/has_grav/cateor_shrine)
"J" = (
/mob/living/basic/pet/cat/feral,
/turf/open/misc/asteroid,
/area/ruin/space/has_grav/cateor_shrine)
"L" = (
/obj/structure/table/bronze,
/obj/item/book/granter/action/spell/fulp/direct_cat_meteor,
/turf/open/floor/bamboo,
/area/ruin/space/has_grav/cateor_shrine)
"M" = (
/obj/structure/flora/rock/pile,
/turf/open/misc/asteroid,
/area/ruin/space/has_grav/cateor_shrine)
"N" = (
/obj/effect/decal/cleanable/dirt/dust,
/obj/item/gps/spaceruin,
/turf/open/misc/asteroid,
/area/ruin/space/has_grav/cateor_shrine)
"P" = (
/obj/item/staff,
/turf/open/misc/asteroid,
/area/ruin/space/has_grav/cateor_shrine)
"Q" = (
/turf/closed/mineral/random/high_chance,
/area/ruin/space/has_grav/cateor_shrine)
"R" = (
/turf/open/misc/asteroid,
/area/ruin/space/has_grav/cateor_shrine)
"S" = (
/obj/structure/cat_house,
/turf/open/floor/bamboo,
/area/ruin/space/has_grav/cateor_shrine)
"T" = (
/obj/structure/mineral_door/silver,
/obj/structure/fans/tiny/invisible,
/turf/open/misc/asteroid,
/area/ruin/space/has_grav/cateor_shrine)
"V" = (
/obj/item/food/deadmouse,
/obj/effect/turf_decal/siding/wood,
/mob/living/basic/pet/cat/feral,
/turf/open/floor/holofloor/wood,
/area/ruin/space/has_grav/cateor_shrine)

(1,1,1) = {"
a
a
a
y
y
y
y
y
y
a
a
a
"}
(2,1,1) = {"
a
a
y
y
y
Q
Q
y
y
y
a
a
"}
(3,1,1) = {"
a
y
y
y
y
y
y
Q
Q
y
y
a
"}
(4,1,1) = {"
y
y
y
d
h
y
y
y
Q
Q
y
a
"}
(5,1,1) = {"
y
y
f
d
J
R
y
y
y
y
y
y
"}
(6,1,1) = {"
y
y
S
V
o
u
y
y
M
N
y
y
"}
(7,1,1) = {"
y
y
L
d
R
J
y
E
R
R
y
y
"}
(8,1,1) = {"
y
y
S
p
u
R
y
P
R
R
R
T
"}
(9,1,1) = {"
y
y
f
d
J
R
C
R
m
i
y
y
"}
(10,1,1) = {"
y
y
y
d
h
J
y
j
R
y
y
y
"}
(11,1,1) = {"
a
y
y
y
y
y
y
y
y
y
y
a
"}
(12,1,1) = {"
a
a
y
y
y
y
y
y
y
y
a
a
"}
