//MAP CONVERTED BY dmm2tgm.py THIS HEADER COMMENT PREVENTS RECONVERSION, DO NOT REMOVE
"a" = (
/turf/open/floor/light/colour_cycle/dancefloor_a,
/area/ruin/space/has_grav/disco_shrine)
"q" = (
/turf/open/floor/light/colour_cycle/dancefloor_b,
/area/ruin/space/has_grav/disco_shrine)
"y" = (
/turf/open/floor/mineral/plasma,
/area/ruin/space/has_grav/disco_shrine)
"z" = (
/obj/effect/spawner/structure/window/hollow/plasma,
/obj/structure/marker_beacon/purple,
/turf/open/floor/mineral/plasma,
/area/ruin/space/has_grav/disco_shrine)
"D" = (
/obj/effect/spawner/structure/window/hollow/plasma,
/obj/structure/marker_beacon/indigo,
/turf/open/floor/mineral/plasma,
/area/ruin/space/has_grav/disco_shrine)
"E" = (
/obj/item/clothing/neck/tie/disco,
/turf/open/floor/light/colour_cycle/dancefloor_b,
/area/ruin/space/has_grav/disco_shrine)
"G" = (
/obj/item/clothing/suit/jacket/det_suit/disco,
/turf/open/floor/light/colour_cycle/dancefloor_a,
/area/ruin/space/has_grav/disco_shrine)
"K" = (
/obj/effect/spawner/structure/window/hollow/plasma,
/obj/structure/marker_beacon/violet,
/turf/open/floor/mineral/plasma,
/area/ruin/space/has_grav/disco_shrine)
"L" = (
/turf/open/space/basic,
/area/template_noop)
"N" = (
/obj/item/book/granter/action/spell/fulp/summon_dancefloor,
/obj/item/gps/spaceruin{
	pixel_x = 7;
	pixel_y = -2
	},
/turf/open/floor/light/colour_cycle/dancefloor_a,
/area/ruin/space/has_grav/disco_shrine)
"P" = (
/obj/effect/spawner/structure/window/hollow/plasma,
/obj/structure/marker_beacon/fuchsia,
/turf/open/floor/mineral/plasma,
/area/ruin/space/has_grav/disco_shrine)
"V" = (
/obj/machinery/jukebox/disco,
/turf/open/floor/light/colour_cycle/dancefloor_b,
/area/ruin/space/has_grav/disco_shrine)

(1,1,1) = {"
L
y
y
y
y
y
L
"}
(2,1,1) = {"
y
z
q
G
q
P
y
"}
(3,1,1) = {"
y
q
a
q
a
q
y
"}
(4,1,1) = {"
y
a
q
V
q
a
y
"}
(5,1,1) = {"
y
q
a
q
N
q
y
"}
(6,1,1) = {"
y
D
E
a
q
K
y
"}
(7,1,1) = {"
L
y
y
y
y
y
L
"}
