//MAP CONVERTED BY dmm2tgm.py THIS HEADER COMMENT PREVENTS RECONVERSION, DO NOT REMOVE
"a" = (
/turf/open/floor/light/colour_cycle/dancefloor_a/airless,
/area/ruin/space/has_grav/disco_shrine)
"q" = (
/turf/open/floor/light/colour_cycle/dancefloor_b/airless,
/area/ruin/space/has_grav/disco_shrine)
"y" = (
/turf/open/floor/mineral/plasma/disco/airless,
/area/ruin/space/has_grav/disco_shrine)
"z" = (
/obj/effect/spawner/structure/window/hollow/plasma,
/turf/open/floor/mineral/plasma/disco/airless,
/area/ruin/space/has_grav/disco_shrine)
"D" = (
/obj/structure/marker_beacon/indigo,
/turf/open/floor/light/colour_cycle/dancefloor_a/airless,
/area/ruin/space/has_grav/disco_shrine)
"E" = (
/obj/item/clothing/neck/tie/disco,
/turf/open/floor/light/colour_cycle/dancefloor_b/airless,
/area/ruin/space/has_grav/disco_shrine)
"G" = (
/obj/item/clothing/suit/jacket/det_suit/disco,
/turf/open/floor/light/colour_cycle/dancefloor_a/airless,
/area/ruin/space/has_grav/disco_shrine)
"K" = (
/obj/structure/marker_beacon/fuchsia,
/turf/open/floor/light/colour_cycle/dancefloor_a/airless,
/area/ruin/space/has_grav/disco_shrine)
"L" = (
/turf/open/space/basic,
/area/template_noop)
"N" = (
/obj/item/book/granter/action/spell/fulp/summon_dancefloor,
/obj/item/gps/spaceruin{
	pixel_x = 7;
	pixel_y = -2
	},
/obj/structure/marker_beacon/violet,
/turf/open/floor/light/colour_cycle/dancefloor_a/airless,
/area/ruin/space/has_grav/disco_shrine)
"P" = (
/obj/structure/marker_beacon/purple,
/turf/open/floor/light/colour_cycle/dancefloor_a/airless,
/area/ruin/space/has_grav/disco_shrine)
"V" = (
/obj/machinery/jukebox/disco,
/turf/open/floor/light/colour_cycle/dancefloor_b/airless,
/area/ruin/space/has_grav/disco_shrine)

(1,1,1) = {"
L
y
y
y
y
y
L
"}
(2,1,1) = {"
y
z
q
G
q
z
y
"}
(3,1,1) = {"
y
q
P
q
K
q
y
"}
(4,1,1) = {"
y
a
q
V
q
a
y
"}
(5,1,1) = {"
y
q
D
q
N
q
y
"}
(6,1,1) = {"
y
z
E
a
q
z
y
"}
(7,1,1) = {"
L
y
y
y
y
y
L
"}
